game_no,team,opp,result,location,FG,FGA,x2P,x2PA,x3P,x3PA,FT,FTA,PTS
1,BOS,MIL,W,H,41,91,29,54,12,37,18,26,112
2,MIL,BOS,L,H,37,84,31,61,6,23,14,17,94
3,BRK,CHI,L,H,28,86,25,53,3,33,14,18,73
4,CHI,BRK,W,H,41,95,27,65,14,30,16,21,112
5,CLE,TOR,L,H,28,76,18,39,10,37,17,24,83
6,TOR,CLE,W,H,40,86,32,60,8,26,10,16,98
7,GSW,LAL,W,H,41,90,29,54,12,36,15,22,109
8,LAL,GSW,L,H,41,93,37,76,4,17,8,14,94
9,HOU,MIN,W,H,45,97,26,41,19,56,14,22,123
10,MIN,HOU,L,H,48,91,37,68,11,23,11,15,118
11,ATL,IND,L,H,30,72,19,43,11,29,15,19,86
12,IND,ATL,W,H,39,82,29,58,10,24,16,19,104
13,LAC,SAC,W,H,43,83,33,55,10,28,19,25,115
14,SAC,LAC,L,H,40,81,35,70,5,11,10,14,95
15,DAL,MEM,W,H,33,75,24,41,9,34,25,31,100
16,MEM,DAL,L,H,33,84,25,59,8,25,19,22,93
17,MIA,WAS,W,H,46,88,38,64,8,24,10,12,110
18,WAS,MIA,L,H,42,87,35,61,7,26,11,14,102
19,NYK,PHI,W,H,41,83,32,61,9,22,23,32,114
20,PHI,NYK,L,H,46,93,39,70,7,23,14,20,113
21,DEN,OKC,W,H,39,85,32,60,7,25,26,32,111
22,OKC,DEN,L,H,43,101,35,76,8,25,11,17,105
23,DET,ORL,L,H,41,106,30,70,11,36,16,28,109
24,ORL,DET,W,H,42,87,29,62,13,25,16,17,113
25,NOP,POR,W,H,40,90,32,66,8,24,15,21,103
26,POR,NOP,L,H,41,85,28,55,13,30,5,13,100
27,SAS,UTA,L,H,39,86,31,65,8,21,11,13,97
28,UTA,SAS,W,H,39,77,29,51,10,26,13,20,101
29,ATL,CHO,W,H,41,79,34,52,7,27,14,18,103
30,CHO,ATL,L,H,29,88,26,65,3,23,15,19,76
31,DAL,DEN,L,H,35,88,23,48,12,40,9,11,91
32,DEN,DAL,W,H,41,84,23,42,18,42,9,14,109
33,LAL,NOP,W,H,42,88,34,66,8,22,16,23,108
34,NOP,LAL,L,H,37,79,30,57,7,22,15,20,96
35,MIN,OKC,L,H,38,86,33,66,5,20,17,25,98
36,OKC,MIN,W,H,37,86,30,64,7,22,19,25,100
37,PHO,SAC,L,H,41,109,33,79,8,30,14,24,104
38,SAC,PHO,W,H,43,83,34,64,9,19,34,43,129
39,BOS,BRK,W,H,41,91,27,53,14,38,18,21,114
40,BRK,BOS,L,H,31,86,23,55,8,31,35,39,105
41,CHI,ORL,W,H,48,89,36,63,12,26,14,16,122
42,ORL,CHI,L,H,29,84,24,57,5,27,12,16,75
43,DET,WAS,L,H,43,94,33,68,10,26,5,5,101
44,WAS,DET,W,H,42,83,35,64,7,19,14,16,105
45,GSW,UTA,L,H,39,80,30,55,9,25,12,17,99
46,UTA,GSW,W,H,41,92,28,57,13,35,10,15,105
47,HOU,LAC,L,H,33,84,24,44,9,40,21,27,96
48,LAC,HOU,W,H,46,91,36,65,10,26,23,28,125
49,CLE,MIA,L,H,44,89,30,54,14,35,19,22,121
50,MIA,CLE,W,H,44,95,32,62,12,33,24,34,124
51,CHO,MIL,L,H,33,81,28,63,5,18,8,13,79
52,MIL,CHO,W,H,35,78,19,51,16,27,3,5,89
53,IND,PHI,W,H,49,85,44,69,5,16,17,21,120
54,PHI,IND,L,H,35,75,22,42,13,33,28,31,111
55,POR,SAS,W,H,37,89,25,62,12,27,13,15,99
56,SAS,POR,L,H,38,83,30,62,8,21,14,20,98
57,ATL,CLE,W,H,44,94,35,63,9,31,29,37,126
58,CLE,ATL,L,H,45,98,26,52,19,46,16,20,125
59,DEN,OKC,L,H,40,84,29,50,11,34,14,15,105
60,OKC,DEN,W,H,40,96,34,71,6,25,20,22,106
61,LAL,MIN,W,H,42,86,32,59,10,27,16,20,110
62,MIN,LAL,L,H,40,80,37,65,3,15,26,31,109
63,DET,MEM,W,H,39,82,25,54,14,28,11,16,103
64,MEM,DET,L,H,36,75,27,54,9,21,9,13,90
65,NYK,TOR,L,H,37,82,28,54,9,28,14,15,97
66,TOR,NYK,W,H,40,77,30,46,10,31,20,23,110
67,DAL,PHO,L,H,41,97,25,52,16,45,13,19,111
68,PHO,DAL,W,H,44,80,36,61,8,19,28,32,124
69,HOU,SAC,W,H,45,80,27,37,18,43,27,31,135
70,SAC,HOU,L,H,47,94,38,63,9,31,25,30,128
71,BRK,CHI,W,H,39,92,29,61,10,31,19,24,107
72,CHI,BRK,L,H,40,90,29,66,11,24,15,17,106
73,BOS,CHO,W,H,45,87,28,48,17,39,14,17,121
74,CHO,BOS,L,H,38,84,29,56,9,28,29,32,114
75,GSW,NOP,W,H,49,96,39,63,10,33,15,16,123
76,NOP,GSW,L,H,42,86,37,65,5,21,12,19,101
77,IND,ORL,W,H,51,86,40,64,11,22,14,19,127
78,ORL,IND,L,H,41,84,27,54,14,30,16,22,112
79,MIL,PHI,W,H,35,79,29,52,6,27,14,20,90
80,PHI,MIL,L,H,27,77,19,46,8,31,20,23,82
81,POR,UTA,W,H,37,91,24,61,13,30,14,16,101
82,UTA,POR,L,H,31,78,25,59,6,19,18,24,86
83,LAC,SAS,W,H,42,84,36,62,6,22,8,14,98
84,SAS,LAC,L,H,34,80,26,58,8,22,11,14,87
85,MIA,WAS,W,H,37,80,30,62,7,18,25,36,106
86,WAS,MIA,L,H,39,81,31,59,8,22,17,22,103
87,ATL,CLE,W,H,45,89,29,52,16,37,8,8,114
88,CLE,ATL,L,H,39,81,30,45,9,36,13,17,100
89,DAL,SAS,L,H,38,88,30,62,8,26,5,8,89
90,SAS,DAL,W,H,40,96,31,68,9,28,13,22,102
91,DEN,NOP,W,H,43,78,30,46,13,32,23,32,122
92,NOP,DEN,L,H,47,99,44,76,3,23,9,13,106
93,DET,HOU,W,H,46,108,37,82,9,26,13,16,114
94,HOU,DET,L,H,36,87,20,36,16,51,21,28,109
95,LAL,SAC,W,H,38,86,34,62,4,24,18,25,98
96,SAC,LAL,L,H,38,75,30,55,8,20,10,13,94
97,MEM,NYK,W,H,38,75,23,48,15,27,10,12,101
98,NYK,MEM,L,H,38,88,32,60,6,28,6,13,88
99,OKC,PHO,L,H,34,92,27,62,7,30,24,33,99
100,PHO,OKC,W,H,43,83,35,65,8,18,26,31,120
101,MIA,TOR,L,H,33,83,25,60,8,23,20,29,94
102,TOR,MIA,W,H,35,85,26,65,9,20,17,24,96
103,MIN,UTA,L,H,39,79,32,63,7,16,28,28,113
104,UTA,MIN,W,H,45,75,31,50,14,25,16,22,120
105,ATL,BOS,W,H,44,89,33,66,11,23,24,34,123
106,BOS,ATL,L,H,37,90,22,47,15,43,27,34,116
107,IND,MIL,W,H,38,80,30,55,8,25,20,26,104
108,MIL,IND,L,H,33,71,22,47,11,24,12,14,89
109,NYK,WAS,L,H,40,95,33,75,7,20,16,21,103
110,WAS,NYK,W,H,36,74,22,40,14,34,20,28,106
111,BRK,ORL,L,H,40,87,29,57,11,30,16,22,107
112,ORL,BRK,W,H,42,90,33,65,9,25,22,26,115
113,CHI,PHI,W,H,39,91,31,66,8,25,16,17,102
114,PHI,CHI,L,H,33,91,26,58,7,33,17,22,90
115,MIN,POR,L,H,38,87,34,69,4,18,18,20,98
116,POR,MIN,W,H,35,81,21,48,14,33,21,26,105
117,BOS,CLE,L,H,33,81,26,48,7,33,18,29,91
118,CLE,BOS,W,H,43,92,32,56,11,36,17,18,114
119,CHO,MIA,L,H,35,78,27,53,8,25,21,24,99
120,MIA,CHO,W,H,40,84,19,44,21,40,11,12,112
121,DET,TOR,L,H,42,81,35,60,7,21,11,18,102
122,TOR,DET,W,H,41,87,31,57,10,30,13,15,105
123,DEN,HOU,L,H,41,104,34,66,7,38,15,18,104
124,HOU,DEN,W,H,37,87,27,53,10,34,26,38,110
125,DAL,LAC,L,H,38,86,27,55,11,31,14,18,101
126,LAC,DAL,W,H,38,75,26,44,12,31,24,31,112
127,MEM,OKC,L,H,37,78,28,52,9,26,17,21,100
128,OKC,MEM,W,H,37,85,23,54,14,31,15,24,103
129,GSW,PHO,W,H,45,89,32,59,13,30,17,24,120
130,PHO,GSW,L,H,43,103,36,76,7,27,18,26,111
131,LAL,SAS,W,H,42,86,35,72,7,14,11,14,102
132,SAS,LAL,L,H,39,89,26,54,13,35,4,6,95
133,CLE,ORL,W,H,44,82,26,46,18,36,16,21,122
134,ORL,CLE,L,H,33,86,22,53,11,33,25,26,102
135,GSW,MIN,W,H,44,84,30,52,14,32,19,24,121
136,MIN,GSW,L,H,41,96,37,77,4,19,21,26,107
137,IND,TOR,W,H,39,89,27,64,12,25,18,18,108
138,TOR,IND,L,H,34,76,29,53,5,23,17,19,90
139,DEN,NOP,W,H,53,99,40,69,13,30,15,21,134
140,NOP,DEN,L,H,51,100,37,68,14,32,15,17,131
141,CHI,NYK,L,H,32,85,26,58,6,27,21,23,91
142,NYK,CHI,W,H,42,89,36,66,6,23,10,16,100
143,MIL,OKC,L,H,29,81,26,63,3,18,18,26,79
144,OKC,MIL,W,H,40,84,31,56,9,28,21,25,110
145,BRK,PHI,W,H,48,75,32,44,16,31,29,33,141
146,PHI,BRK,L,H,43,97,31,59,12,38,20,27,118
147,DAL,SAC,L,H,32,80,20,37,12,43,11,14,87
148,SAC,DAL,W,H,36,81,24,59,12,22,14,17,98
149,MEM,SAS,L,H,35,89,27,64,8,25,11,18,89
150,SAS,MEM,W,H,35,80,24,59,11,21,14,18,95
151,POR,UTA,L,H,33,83,27,57,6,26,15,17,87
152,UTA,POR,W,H,39,74,26,51,13,23,15,19,106
153,CHO,WAS,L,H,40,79,28,45,12,34,19,22,111
154,WAS,CHO,W,H,43,85,26,51,17,34,15,18,118
155,MIN,POR,W,H,41,84,37,75,4,9,24,28,110
156,POR,MIN,L,H,38,86,27,54,11,32,22,25,109
157,ATL,BRK,L,H,30,80,23,56,7,24,15,23,82
158,BRK,ATL,W,H,32,82,22,49,10,33,17,20,91
159,CLE,IND,W,H,47,95,29,52,18,43,23,33,135
160,IND,CLE,L,H,48,105,32,64,16,41,18,20,130
161,GSW,WAS,W,H,50,88,34,52,16,36,23,26,139
162,WAS,GSW,L,H,43,92,33,65,10,27,19,25,115
163,LAL,MEM,W,H,40,85,33,66,7,19,21,27,108
164,MEM,LAL,L,H,40,80,27,50,13,30,10,14,103
165,DEN,MIA,W,H,44,87,39,67,5,20,23,27,116
166,MIA,DEN,L,H,42,87,29,60,13,27,16,21,113
167,DAL,MIL,W,H,38,73,24,37,14,36,19,20,109
168,MIL,DAL,L,H,39,77,27,43,12,34,15,18,105
169,CHI,NOP,W,H,45,92,32,66,13,26,14,18,117
170,NOP,CHI,L,H,33,81,23,51,10,30,34,35,110
171,BOS,NYK,W,H,40,72,28,35,12,37,18,26,110
172,NYK,BOS,L,H,33,85,26,60,7,25,21,25,94
173,CHO,OKC,W,H,37,77,26,47,11,30,28,32,113
174,OKC,CHO,L,H,39,84,27,53,12,31,11,12,101
175,HOU,PHO,W,H,47,100,33,62,14,38,15,23,123
176,PHO,HOU,L,H,42,100,34,66,8,34,24,29,116
177,SAS,UTA,W,H,40,77,30,58,10,19,19,22,109
178,UTA,SAS,L,H,43,89,34,65,9,24,8,13,103
179,PHI,TOR,L,H,36,80,25,44,11,36,22,25,105
180,TOR,PHI,W,H,46,85,40,66,6,19,15,19,113
181,BRK,ORL,W,H,50,94,42,63,8,31,13,16,121
182,ORL,BRK,L,H,45,91,35,66,10,25,11,15,111
183,ATL,CHI,L,H,40,90,29,62,11,28,13,17,104
184,CHI,ATL,W,H,40,85,28,55,12,30,14,14,106
185,LAC,LAL,W,H,38,69,27,44,11,25,28,34,115
186,LAL,LAC,L,H,39,90,33,67,6,23,20,30,104
187,MIN,SAC,L,H,39,87,30,60,9,27,30,38,117
188,SAC,MIN,W,H,44,78,33,59,11,19,24,33,123
189,PHO,POR,L,H,44,84,41,74,3,10,26,32,117
190,POR,PHO,W,H,43,92,28,55,15,37,29,31,130
191,BOS,ORL,W,H,38,84,26,51,12,33,29,34,117
192,ORL,BOS,L,H,40,98,28,68,12,30,24,25,116
193,CHO,DEN,W,H,40,86,23,50,17,36,25,30,122
194,DEN,CHO,L,H,45,90,29,57,16,33,8,11,114
195,CLE,PHI,W,H,50,95,37,66,13,29,9,16,122
196,PHI,CLE,L,H,40,82,29,49,11,33,14,19,105
197,GSW,HOU,W,H,43,95,32,63,11,32,10,14,107
198,HOU,GSW,L,H,34,91,22,54,12,37,18,23,98
199,DAL,MEM,L,H,29,76,17,42,12,34,20,25,90
200,MEM,DAL,W,H,35,75,24,48,11,27,18,20,99
201,MIA,NYK,L,H,34,83,26,50,8,33,18,25,94
202,NYK,MIA,W,H,38,80,32,64,6,16,16,17,98
203,DET,MIL,L,H,44,97,37,67,7,30,10,16,105
204,MIL,DET,W,H,35,84,21,48,14,36,24,34,108
205,NOP,SAC,W,H,46,95,36,62,10,33,15,19,117
206,SAC,NOP,L,H,35,90,29,70,6,20,13,17,89
207,OKC,SAS,L,H,33,81,27,60,6,21,23,27,95
208,SAS,OKC,W,H,37,85,28,58,9,27,17,27,100
209,IND,TOR,L,H,36,87,25,61,11,26,17,21,100
210,TOR,IND,W,H,37,82,23,55,14,27,23,35,111
211,UTA,WAS,W,H,33,72,23,47,10,25,19,31,95
212,WAS,UTA,L,H,35,87,30,70,5,17,13,16,88
213,CHI,CLE,W,H,38,90,26,65,12,25,11,18,99
214,CLE,CHI,L,H,37,83,27,56,10,27,9,16,93
215,BRK,DET,L,H,35,92,25,61,10,31,9,12,89
216,DET,BRK,W,H,36,86,29,68,7,18,11,17,90
217,LAL,MIN,L,H,40,84,31,57,9,27,15,16,104
218,MIN,LAL,W,H,43,89,33,68,10,21,23,30,119
219,LAC,PHO,W,H,44,80,32,58,12,22,24,34,124
220,PHO,LAC,L,H,49,92,42,69,7,23,13,24,118
221,HOU,POR,L,H,40,91,32,57,8,34,19,23,107
222,POR,HOU,W,H,43,90,30,57,13,33,18,22,117
223,BOS,MIL,L,H,35,88,23,51,12,37,18,23,100
224,MIL,BOS,W,H,41,78,33,56,8,22,13,17,103
225,LAC,WAS,W,H,47,83,35,53,12,30,27,37,133
226,WAS,LAC,L,H,46,93,33,59,13,34,19,29,124
227,IND,MEM,L,H,37,85,27,60,10,25,13,15,97
228,MEM,IND,W,H,41,88,29,56,12,32,16,18,110
229,DAL,NOP,L,H,44,91,30,64,14,27,16,17,118
230,NOP,DAL,W,H,42,84,30,54,12,30,25,33,121
231,MIA,NYK,W,H,40,84,28,59,12,25,13,17,105
232,NYK,MIA,L,H,33,89,28,64,5,25,17,21,88
233,OKC,ORL,W,H,43,102,33,69,10,33,18,28,114
234,ORL,OKC,L,H,39,97,30,67,9,30,19,27,106
235,ATL,PHI,W,H,34,80,25,62,9,18,22,26,99
236,PHI,ATL,L,H,36,87,25,48,11,39,9,11,92
237,SAC,UTA,L,H,34,75,32,60,2,15,12,18,82
238,UTA,SAC,W,H,42,79,29,48,13,31,15,19,112
239,GSW,SAS,W,H,43,85,30,59,13,26,11,11,110
240,SAS,GSW,L,H,34,83,25,59,9,24,21,26,98
241,CHO,TOR,W,H,39,86,23,54,16,32,16,21,110
242,TOR,CHO,L,H,38,83,27,52,11,31,19,24,106
243,ATL,PHO,W,H,34,85,28,58,6,27,21,29,95
244,PHO,ATL,L,H,35,96,28,65,7,31,14,24,91
245,BRK,PHI,L,H,38,94,29,62,9,32,16,24,101
246,PHI,BRK,W,H,39,91,29,58,10,33,18,21,106
247,CHO,MIL,L,H,39,80,32,52,7,28,23,29,108
248,MIL,CHO,W,H,46,74,32,44,14,30,12,17,118
249,DET,MIA,L,H,36,85,28,58,8,27,16,21,96
250,MIA,DET,W,H,36,79,31,58,5,21,20,28,97
251,GSW,HOU,W,H,45,88,34,47,11,41,12,16,113
252,HOU,GSW,L,H,33,85,28,54,5,31,35,39,106
253,IND,MIN,L,H,40,81,35,63,5,18,29,35,114
254,MIN,IND,W,H,37,78,28,58,9,20,32,37,115
255,LAL,WAS,L,H,43,85,35,63,8,22,14,16,108
256,WAS,LAL,W,H,48,94,42,71,6,23,17,25,119
257,DEN,POR,L,H,44,94,35,64,9,30,16,20,113
258,POR,DEN,W,H,45,91,37,64,8,27,24,33,122
259,DAL,OKC,L,H,33,80,23,51,10,29,15,19,91
260,OKC,DAL,W,H,37,85,31,62,6,23,12,14,92
261,DET,NYK,L,H,36,84,27,61,9,23,14,21,95
262,NYK,DET,W,H,45,84,38,63,7,21,12,13,109
263,MEM,SAC,L,H,31,90,26,64,5,26,23,29,90
264,SAC,MEM,W,H,31,67,25,42,6,25,23,30,91
265,CLE,SAS,L,H,31,83,27,57,4,26,8,13,74
266,SAS,CLE,W,H,41,86,34,60,7,26,14,17,103
267,ORL,TOR,L,H,43,88,39,68,4,20,22,28,112
268,TOR,ORL,W,H,49,83,39,68,10,15,23,35,131
269,NOP,UTA,L,H,37,80,27,55,10,25,16,24,100
270,UTA,NOP,W,H,41,85,26,58,15,27,11,18,108
271,ATL,BRK,L,H,34,98,29,71,5,27,19,32,92
272,BRK,ATL,W,H,38,86,32,64,6,22,25,30,107
273,BOS,MIA,W,H,41,77,33,53,8,24,22,25,112
274,MIA,BOS,L,H,41,91,34,62,7,29,19,24,108
275,CHO,PHO,W,H,42,87,28,57,14,30,22,24,120
276,PHO,CHO,L,H,41,81,35,65,6,16,18,22,106
277,DEN,NOP,L,H,36,95,30,70,6,25,12,14,90
278,NOP,DEN,W,H,48,97,39,70,9,27,10,12,115
279,GSW,MEM,W,H,39,71,22,40,17,31,11,15,106
280,MEM,GSW,L,H,38,85,30,56,8,29,10,15,94
281,HOU,OKC,W,H,50,79,30,40,20,39,17,21,137
282,OKC,HOU,L,H,47,94,36,64,11,30,20,28,125
283,IND,PHI,W,H,38,89,31,72,7,17,24,29,107
284,PHI,IND,L,H,35,88,21,47,14,41,10,14,94
285,LAC,SAC,L,H,32,78,22,49,10,29,23,28,97
286,SAC,LAC,W,H,38,84,25,56,13,28,9,13,98
287,LAL,POR,L,H,33,84,28,63,5,21,10,17,81
288,POR,LAL,W,H,36,89,24,61,12,28,13,18,97
289,CHI,MIL,W,H,46,85,36,64,10,21,7,10,109
290,MIL,CHI,L,H,37,84,30,61,7,23,13,17,94
291,CLE,WAS,L,H,41,83,29,50,12,33,21,27,115
292,WAS,CLE,W,H,49,82,41,64,8,18,21,26,127
293,DAL,TOR,L,H,31,82,24,54,7,28,17,20,86
294,TOR,DAL,W,H,39,81,30,60,9,21,7,9,94
295,LAC,UTA,W,H,38,84,31,57,7,27,25,28,108
296,UTA,LAC,L,H,37,86,29,60,8,26,13,18,95
297,MIN,POR,L,H,37,76,35,66,2,10,24,32,100
298,POR,MIN,W,H,45,71,34,49,11,22,11,17,112
299,NYK,SAS,L,H,41,87,38,77,3,10,13,15,98
300,SAS,NYK,W,H,45,99,35,74,10,25,6,8,106
301,BOS,PHO,W,H,44,94,30,53,14,41,28,35,130
302,PHO,BOS,L,H,39,86,33,67,6,19,36,49,120
303,CHI,PHI,L,H,37,91,27,67,10,24,23,31,107
304,PHI,CHI,W,H,46,83,38,58,8,25,17,23,117
305,CHO,CLE,L,H,38,90,28,52,10,38,19,24,105
306,CLE,CHO,W,H,41,74,32,49,9,25,21,24,112
307,GSW,SAC,W,H,44,89,34,58,10,31,16,18,114
308,SAC,GSW,L,H,40,83,30,62,10,21,10,13,100
309,HOU,NOP,W,H,44,93,30,54,14,39,15,20,117
310,NOP,HOU,L,H,41,91,27,53,14,38,11,14,107
311,DEN,IND,W,H,39,82,32,55,7,27,40,43,125
312,IND,DEN,L,H,48,95,35,71,13,24,8,11,117
313,LAL,MIN,W,H,46,88,32,65,14,23,24,28,130
314,MIN,LAL,L,H,46,95,39,74,7,21,20,22,119
315,ATL,MIL,L,H,34,83,26,61,8,22,21,24,97
316,MIL,ATL,W,H,39,88,31,61,8,27,14,16,100
317,DET,ORL,L,H,34,96,32,74,2,22,17,20,87
318,ORL,DET,W,H,47,91,35,65,12,26,9,13,115
319,BRK,WAS,L,H,43,82,40,67,3,15,19,26,108
320,WAS,BRK,W,H,49,97,39,71,10,26,21,22,129
321,BRK,PHO,W,H,43,95,35,66,8,29,32,42,126
322,PHO,BRK,L,H,34,93,27,68,7,25,23,34,98
323,DAL,LAC,W,H,38,82,29,56,9,26,12,18,97
324,LAC,DAL,L,H,36,80,27,53,9,27,14,21,95
325,MIA,TOR,L,H,32,82,26,59,6,23,14,23,84
326,TOR,MIA,W,H,35,79,29,56,6,23,25,32,101
327,NYK,POR,L,H,36,88,31,66,5,22,18,20,95
328,POR,NYK,W,H,39,80,28,59,11,21,21,29,110
329,MEM,SAS,L,H,34,78,24,49,10,29,12,15,90
330,SAS,MEM,W,H,37,77,29,51,8,26,15,23,97
331,BOS,IND,W,H,43,84,32,57,11,27,12,14,109
332,IND,BOS,L,H,38,87,27,59,11,28,13,19,100
333,CHI,DET,W,H,47,80,36,57,11,23,12,19,117
334,DET,CHI,L,H,39,88,32,68,7,20,10,17,95
335,CLE,DEN,L,H,43,85,28,48,15,37,12,14,113
336,DEN,CLE,W,H,51,96,40,70,11,26,13,13,126
337,OKC,PHI,W,H,48,88,44,72,4,16,22,30,122
338,PHI,OKC,L,H,37,87,29,62,8,25,15,17,97
339,CHO,ORL,W,H,42,90,33,63,9,27,16,18,109
340,ORL,CHO,L,H,40,88,26,48,14,40,8,10,102
341,MIL,SAC,W,H,43,81,27,46,16,35,14,19,116
342,SAC,MIL,L,H,41,84,31,58,10,26,6,10,98
343,NYK,UTA,L,H,38,80,29,59,9,21,16,18,101
344,UTA,NYK,W,H,41,90,34,62,7,28,19,29,108
345,ATL,WAS,L,H,34,86,26,61,8,25,24,29,100
346,WAS,ATL,W,H,38,95,27,61,11,34,17,23,104
347,BRK,DET,W,H,38,88,28,59,10,29,12,19,98
348,DET,BRK,L,H,40,92,35,69,5,23,11,16,96
349,DAL,GSW,L,H,33,92,22,58,11,34,10,12,87
350,GSW,DAL,W,H,43,78,30,48,13,30,13,16,112
351,LAC,LAL,W,H,45,84,30,51,15,33,28,32,133
352,LAL,LAC,L,H,43,92,37,72,6,20,17,27,109
353,MIA,PHO,W,H,42,96,31,69,11,27,17,23,112
354,PHO,MIA,L,H,36,82,32,66,4,16,21,29,97
355,MIN,SAS,L,H,32,72,25,57,7,15,22,25,93
356,SAS,MIN,W,H,37,77,29,53,8,24,18,22,100
357,MEM,NOP,L,H,32,79,23,44,9,35,9,13,82
358,NOP,MEM,W,H,35,88,26,59,9,29,16,19,95
359,MIL,POR,W,H,38,90,31,74,7,16,10,12,93
360,POR,MIL,L,H,35,83,31,62,4,21,16,26,90
361,CHI,TOR,L,H,42,90,28,53,14,37,22,27,120
362,TOR,CHI,W,H,47,95,39,72,8,23,20,27,122
363,BOS,WAS,W,H,40,93,30,60,10,33,20,28,110
364,WAS,BOS,L,H,37,86,29,51,8,35,20,26,102
365,ATL,CHO,L,H,37,84,25,47,12,37,4,10,90
366,CHO,ATL,W,H,40,80,28,50,12,30,13,20,105
367,DEN,HOU,L,H,44,86,32,57,12,29,24,26,124
368,HOU,DEN,W,H,45,89,28,51,17,38,18,23,125
369,IND,UTA,W,H,38,87,28,67,10,20,21,23,107
370,UTA,IND,L,H,40,88,34,63,6,25,14,20,100
371,LAC,NYK,W,H,43,87,33,56,10,31,18,24,114
372,NYK,LAC,L,H,40,89,34,65,6,24,19,24,105
373,GSW,OKC,W,H,40,83,25,50,15,33,16,21,111
374,OKC,GSW,L,H,37,87,33,66,4,21,17,31,95
375,ORL,PHI,W,H,35,94,31,71,4,23,38,46,112
376,PHI,ORL,L,H,39,102,30,68,9,34,22,24,109
377,BRK,DAL,L,H,31,72,18,41,13,31,29,38,104
378,DAL,BRK,W,H,41,76,31,51,10,25,19,25,111
379,DET,PHO,W,H,40,92,28,67,12,25,20,30,112
380,PHO,DET,L,H,35,99,29,77,6,22,19,30,95
381,CLE,LAL,W,H,45,85,32,49,13,36,22,27,125
382,LAL,CLE,L,H,47,91,36,64,11,27,15,19,120
383,MIA,POR,L,H,41,88,32,58,9,30,13,20,104
384,POR,MIA,W,H,42,83,29,57,13,26,18,24,115
385,MIN,NOP,L,H,44,86,35,61,9,25,12,17,109
386,NOP,MIN,W,H,49,90,35,60,14,30,11,15,123
387,BOS,PHI,L,H,34,84,28,55,6,29,25,29,99
388,PHI,BOS,W,H,41,88,29,55,12,33,11,15,105
389,SAC,SAS,L,H,41,83,34,73,7,10,13,17,102
390,SAS,SAC,W,H,43,87,32,59,11,28,21,27,118
391,IND,TOR,L,H,33,80,27,57,6,23,19,26,91
392,TOR,IND,W,H,45,91,33,64,12,27,14,16,116
393,ATL,POR,L,H,32,88,25,62,7,26,26,32,97
394,POR,ATL,W,H,44,87,36,69,8,18,17,19,113
395,CHI,UTA,W,H,38,80,31,61,7,19,12,14,95
396,UTA,CHI,L,H,31,81,24,56,7,25,17,25,86
397,CHO,WAS,W,H,35,82,26,58,9,24,19,27,98
398,WAS,CHO,L,H,29,79,18,46,11,33,24,31,93
399,DEN,HOU,L,H,38,89,28,58,10,31,19,30,105
400,HOU,DEN,W,H,38,83,33,59,5,24,28,35,109
401,GSW,MIL,W,H,45,75,33,52,12,23,15,19,117
402,MIL,GSW,L,H,36,89,27,62,9,27,11,14,92
403,CLE,LAC,L,H,32,83,27,56,5,27,9,13,78
404,LAC,CLE,W,H,40,78,32,52,8,26,20,29,108
405,MEM,SAS,W,H,32,76,19,46,13,30,27,31,104
406,SAS,MEM,L,H,33,75,24,47,9,28,21,22,96
407,OKC,SAC,W,H,41,82,31,56,10,26,18,25,110
408,SAC,OKC,L,H,35,85,30,64,5,21,19,23,94
409,BOS,BRK,W,H,34,85,27,56,7,29,23,29,98
410,BRK,BOS,L,H,30,83,19,48,11,35,24,30,95
411,DET,TOR,L,H,29,83,26,63,3,20,14,21,75
412,TOR,DET,W,H,30,78,21,51,9,27,18,20,87
413,LAL,MIL,L,H,38,84,27,55,11,29,16,26,103
414,MIL,LAL,W,H,40,82,36,58,4,24,23,30,107
415,MIA,MIN,W,H,50,85,42,59,8,26,15,19,123
416,MIN,MIA,L,H,41,82,39,70,2,12,21,22,105
417,HOU,NOP,L,H,37,91,24,51,13,40,25,32,112
418,NOP,HOU,W,H,49,92,37,58,12,34,18,24,128
419,DAL,PHI,L,H,30,87,25,64,5,23,9,17,74
420,PHI,DAL,W,H,42,80,30,51,12,29,20,23,116
421,ORL,PHO,W,H,42,96,35,73,7,23,18,21,109
422,PHO,ORL,L,H,38,87,36,73,2,14,25,30,103
423,CHI,WAS,L,H,44,88,37,61,7,27,12,18,107
424,WAS,CHI,W,H,46,101,36,75,10,26,10,12,112
425,ATL,MEM,L,H,29,71,21,44,8,27,25,34,91
426,MEM,ATL,W,H,39,92,29,64,10,28,15,18,103
427,CLE,UTA,W,H,36,86,27,53,9,33,10,19,91
428,UTA,CLE,L,H,34,82,29,61,5,21,10,14,83
429,DEN,LAC,W,H,46,86,31,58,15,28,22,26,129
430,LAC,DEN,L,H,44,84,28,52,16,32,10,15,114
431,GSW,ORL,W,H,50,87,40,61,10,26,12,23,122
432,ORL,GSW,L,H,35,94,28,67,7,27,15,21,92
433,BRK,NYK,W,H,41,86,31,54,10,32,29,35,121
434,NYK,BRK,L,H,41,88,38,70,3,18,25,26,110
435,OKC,TOR,W,H,47,88,33,63,14,25,15,19,123
436,TOR,OKC,L,H,37,81,32,61,5,20,23,30,102
437,BOS,MIN,W,H,43,79,30,46,13,33,18,21,117
438,MIN,BOS,L,H,40,91,32,64,8,27,16,20,104
439,CHI,MEM,L,H,34,91,23,63,11,28,12,15,91
440,MEM,CHI,W,H,36,85,25,54,11,31,15,18,98
441,DET,UTA,L,H,36,86,33,73,3,13,8,12,83
442,UTA,DET,W,H,36,77,23,49,13,28,12,16,97
443,HOU,LAL,W,H,50,91,32,48,18,43,21,32,139
444,LAL,HOU,L,H,42,91,39,66,3,25,13,18,100
445,CHO,IND,L,H,32,80,29,57,3,23,10,13,77
446,IND,CHO,W,H,39,73,27,45,12,28,8,9,98
447,LAC,MIL,L,H,35,75,30,51,5,24,21,29,96
448,MIL,LAC,W,H,34,76,24,47,10,29,19,25,97
449,MIA,NOP,W,H,44,87,28,52,16,35,16,19,120
450,NOP,MIA,L,H,42,88,33,66,9,22,19,28,112
451,PHO,SAC,L,H,43,107,37,82,6,25,9,14,101
452,SAC,PHO,W,H,38,79,32,65,6,14,25,34,107
453,POR,SAS,W,H,38,80,29,58,9,22,25,28,110
454,SAS,POR,L,H,42,88,31,62,11,26,11,15,106
455,DAL,WAS,W,H,40,79,26,47,14,32,18,25,112
456,WAS,DAL,L,H,40,82,28,52,12,30,15,21,107
457,BRK,OKC,L,H,33,71,21,47,12,24,26,30,104
458,OKC,BRK,W,H,44,89,34,67,10,22,24,34,122
459,CLE,DET,W,H,46,77,27,47,19,30,17,23,128
460,DET,CLE,L,H,37,99,33,80,4,19,18,19,96
461,GSW,PHI,W,H,32,88,18,56,14,32,28,35,106
462,PHI,GSW,L,H,39,89,31,62,8,27,18,27,104
463,NOP,POR,W,H,38,80,32,59,6,21,18,30,100
464,POR,NOP,L,H,23,76,12,44,11,32,20,26,77
465,IND,NYK,L,H,32,87,24,58,8,29,9,15,81
466,NYK,IND,W,H,35,83,26,55,9,28,8,13,87
467,CHI,CHO,W,H,41,92,27,52,14,40,19,22,115
468,CHO,CHI,L,H,43,93,36,64,7,29,16,19,109
469,DEN,LAL,W,H,45,84,28,46,17,38,22,25,129
470,LAL,DEN,L,H,42,97,36,77,6,20,11,19,101
471,MEM,MIL,W,H,41,79,27,52,14,27,17,23,113
472,MIL,MEM,L,H,31,67,17,41,14,26,17,20,93
473,MIN,WAS,W,H,45,86,35,65,10,21,19,22,119
474,WAS,MIN,L,H,36,84,29,58,7,26,25,31,104
475,ORL,SAC,L,H,45,98,32,64,13,34,12,12,115
476,SAC,ORL,W,H,44,82,28,52,16,30,16,21,120
477,ATL,SAS,L,H,37,81,31,59,6,22,19,30,99
478,SAS,ATL,W,H,39,81,23,47,16,34,13,17,107
479,DAL,TOR,L,H,31,85,24,60,7,25,9,13,78
480,TOR,DAL,W,H,37,78,28,53,9,25,17,18,100
481,LAC,UTA,L,H,39,78,27,48,12,30,18,23,108
482,UTA,LAC,W,H,41,78,27,57,14,21,18,22,114
483,BOS,CHI,W,H,40,86,24,49,16,37,4,4,100
484,CHI,BOS,L,H,33,87,26,62,7,25,7,9,80
485,BRK,NYK,W,H,40,87,21,49,19,38,21,29,120
486,NYK,BRK,L,H,39,94,31,71,8,23,26,32,112
487,CLE,HOU,L,H,42,80,25,37,17,43,11,13,112
488,HOU,CLE,W,H,41,96,25,51,16,45,19,28,117
489,IND,MIA,W,H,35,82,30,67,5,15,27,32,102
490,MIA,IND,L,H,39,94,30,62,9,32,11,16,98
491,LAL,PHI,L,H,44,88,40,68,4,20,24,28,116
492,PHI,LAL,W,H,41,79,31,55,10,24,26,32,118
493,PHO,POR,L,H,41,93,36,79,5,14,14,20,101
494,POR,PHO,W,H,43,86,36,64,7,22,17,25,110
495,CHO,NOP,L,H,46,102,33,56,13,46,17,20,122
496,NOP,CHO,W,H,50,99,36,65,14,34,11,16,125
497,DAL,PHO,L,H,28,74,19,48,9,26,33,36,98
498,PHO,DAL,W,H,38,83,32,62,6,21,18,20,100
499,DET,NYK,W,H,46,96,37,69,9,27,11,19,112
500,NYK,DET,L,H,36,82,23,52,13,30,7,11,92
501,LAC,PHI,W,H,40,81,32,56,8,25,24,29,112
502,PHI,LAC,L,H,40,84,30,54,10,30,10,14,100
503,ATL,MEM,W,H,36,72,21,42,15,30,20,26,107
504,MEM,ATL,L,H,34,90,29,61,5,29,17,23,90
505,MIA,TOR,W,H,35,72,24,44,11,28,23,33,104
506,TOR,MIA,L,H,33,88,31,73,2,15,21,25,89
507,MIL,MIN,W,H,37,80,29,60,8,20,20,23,102
508,MIN,MIL,L,H,37,81,32,68,5,13,16,21,95
509,OKC,UTA,W,H,43,86,35,63,8,23,18,24,112
510,UTA,OKC,L,H,36,75,27,55,9,20,23,28,104
511,CLE,ORL,W,H,43,86,28,47,15,39,15,25,116
512,ORL,CLE,L,H,38,96,34,75,4,21,24,28,104
513,POR,WAS,L,H,48,94,32,62,16,32,12,16,124
514,WAS,POR,W,H,47,90,35,65,12,25,19,28,125
515,DEN,SAC,W,H,40,85,31,51,9,34,16,18,105
516,SAC,DEN,L,H,36,82,28,59,8,23,12,20,92
517,GSW,SAS,L,H,33,92,28,75,5,17,14,23,85
518,SAS,GSW,W,H,40,77,28,50,12,27,15,18,107
519,ATL,TOR,W,H,39,75,31,53,8,22,19,29,105
520,TOR,ATL,L,H,37,92,33,67,4,25,21,27,99
521,CHI,HOU,L,H,38,98,29,59,9,39,9,12,94
522,HOU,CHI,W,H,37,89,22,42,15,47,26,32,115
523,CHO,ORL,W,H,47,79,37,58,10,21,17,20,121
524,ORL,CHO,L,H,31,76,26,49,5,27,14,22,81
525,BRK,DAL,L,H,34,78,25,47,9,31,19,23,96
526,DAL,BRK,W,H,33,78,19,45,14,33,25,28,105
527,BOS,DEN,L,H,34,81,22,48,12,33,19,23,99
528,DEN,BOS,W,H,45,85,33,54,12,31,17,22,119
529,IND,MIL,L,H,33,75,31,57,2,18,17,22,85
530,MIL,IND,W,H,33,64,26,47,7,17,26,30,99
531,GSW,MIN,L,H,41,88,34,64,7,24,13,17,102
532,MIN,GSW,W,H,39,88,35,74,4,14,21,27,103
533,SAC,WAS,L,H,44,92,32,69,12,23,22,28,122
534,WAS,SAC,W,H,52,104,43,78,9,26,17,19,130
535,CLE,DET,L,H,39,84,28,45,11,39,12,19,101
536,DET,CLE,W,H,41,88,32,62,9,26,15,19,106
537,LAC,MEM,W,H,40,78,29,48,11,30,23,28,114
538,MEM,LAC,L,H,37,83,30,63,7,20,17,22,98
539,OKC,SAS,W,H,41,89,35,69,6,20,14,21,102
540,SAS,OKC,L,H,35,84,29,65,6,19,16,20,92
541,LAL,PHO,W,H,47,98,35,71,12,27,16,24,122
542,PHO,LAL,L,H,42,91,36,72,6,19,20,25,110
543,PHI,POR,L,H,41,94,30,65,11,29,15,20,108
544,POR,PHI,W,H,40,88,34,67,6,21,28,33,114
545,ATL,BRK,W,H,41,95,37,75,4,20,24,32,110
546,BRK,ATL,L,H,37,80,26,47,11,33,20,25,105
547,DEN,WAS,L,H,46,87,33,59,13,28,8,17,113
548,WAS,DEN,W,H,50,88,39,62,11,26,12,19,123
549,BOS,GSW,W,H,37,84,27,55,10,29,15,19,99
550,GSW,BOS,L,H,37,84,31,54,6,30,6,9,86
551,HOU,UTA,L,H,35,79,27,47,8,32,30,40,108
552,UTA,HOU,W,H,41,76,29,45,12,31,21,24,115
553,DET,IND,L,H,39,89,32,63,7,26,13,22,98
554,IND,DET,W,H,44,88,33,65,11,23,16,19,115
555,CHO,MIA,L,H,37,80,30,59,7,21,20,21,101
556,MIA,CHO,W,H,37,85,20,44,17,41,17,24,108
557,MIL,NYK,W,H,37,86,29,60,8,26,22,28,104
558,NYK,MIL,L,H,39,84,32,63,7,21,8,12,93
559,LAC,MIN,L,H,35,83,26,59,9,24,12,18,91
560,MIN,LAC,W,H,42,86,37,66,5,20,18,20,107
561,NOP,TOR,L,H,34,80,25,51,9,29,10,13,87
562,TOR,NOP,W,H,36,76,28,55,8,21,14,23,94
563,CHI,ORL,L,H,36,81,24,53,12,28,7,11,91
564,ORL,CHI,W,H,37,89,30,64,7,25,17,21,98
565,SAC,SAS,L,H,42,86,35,67,7,19,13,16,104
566,SAS,SAC,W,H,42,84,28,55,14,29,16,21,114
567,DAL,LAL,W,H,45,83,28,52,17,31,15,19,122
568,LAL,DAL,L,H,42,90,31,60,11,30,16,22,111
569,OKC,POR,L,H,44,85,34,60,10,25,23,30,121
570,POR,OKC,W,H,47,85,36,62,11,23,21,27,126
571,PHO,WAS,L,H,44,88,31,61,13,27,26,33,127
572,WAS,PHO,W,H,41,90,34,72,7,18,42,53,131
573,ATL,GSW,L,H,38,82,25,54,13,28,22,31,111
574,GSW,ATL,W,H,41,87,21,43,20,44,17,22,119
575,CHO,IND,W,H,35,86,24,55,11,31,19,21,100
576,IND,CHO,L,H,37,81,25,51,12,30,2,3,88
577,CLE,MIA,L,H,35,78,26,51,9,27,19,29,98
578,MIA,CLE,W,H,39,91,23,56,16,35,12,14,106
579,DEN,SAC,W,H,37,74,24,44,13,30,21,28,108
580,SAC,DEN,L,H,36,83,30,67,6,16,18,21,96
581,CHI,DET,L,H,34,83,26,55,8,28,19,21,95
582,DET,CHI,W,H,45,92,39,71,6,21,13,20,109
583,BOS,LAC,L,H,34,83,24,48,10,35,24,29,102
584,LAC,BOS,W,H,39,73,30,53,9,20,29,47,116
585,BRK,MEM,W,H,39,73,25,43,14,30,30,38,122
586,MEM,BRK,L,H,34,77,24,52,10,25,31,39,109
587,NYK,ORL,W,H,40,86,34,72,6,14,27,28,113
588,ORL,NYK,L,H,40,85,31,53,9,32,16,24,105
589,MIL,PHI,W,H,41,83,27,50,14,33,16,20,112
590,PHI,MIL,L,H,39,89,31,59,8,30,12,19,98
591,HOU,SAS,L,H,41,88,27,49,14,39,14,17,110
592,SAS,HOU,W,H,40,88,29,60,11,28,21,23,112
593,NOP,UTA,L,H,30,84,20,51,10,33,13,18,83
594,UTA,NOP,W,H,33,81,23,54,10,27,12,15,88
595,ATL,IND,L,H,34,77,25,50,9,27,19,31,96
596,IND,ATL,W,H,35,78,20,45,15,33,12,21,97
597,DAL,OKC,W,H,42,86,35,61,7,25,13,16,104
598,OKC,DAL,L,H,33,82,31,60,2,22,21,30,89
599,LAL,NOP,L,H,38,83,28,55,10,28,11,15,97
600,NOP,LAL,W,H,36,89,27,65,9,24,24,35,105
601,GSW,NYK,W,H,40,88,27,53,13,35,19,23,112
602,NYK,GSW,L,H,39,83,32,61,7,22,20,25,105
603,BOS,PHO,L,H,32,85,19,48,13,37,29,40,106
604,PHO,BOS,W,H,42,94,38,74,4,20,21,26,109
605,SAC,UTA,L,H,43,83,35,66,8,17,15,20,109
606,UTA,SAC,W,H,41,90,31,57,10,33,18,27,110
607,ORL,WAS,L,H,44,89,30,54,14,35,12,19,114
608,WAS,ORL,W,H,39,81,25,55,14,26,23,25,115
609,CHI,LAC,L,H,35,83,29,66,6,17,15,20,91
610,LAC,CHI,W,H,41,85,35,60,6,25,13,16,101
611,CHO,DEN,W,H,41,90,25,63,16,27,14,17,112
612,DEN,CHO,L,H,36,80,27,50,9,30,21,25,102
613,HOU,MEM,W,H,39,78,21,36,18,42,27,36,123
614,MEM,HOU,L,H,43,97,35,69,8,28,14,21,108
615,CLE,MIA,L,H,35,73,24,46,11,27,11,18,92
616,MIA,CLE,W,H,46,88,28,54,18,34,10,12,120
617,MIL,TOR,W,H,38,87,32,60,6,27,19,23,101
618,TOR,MIL,L,H,35,75,28,54,7,21,17,20,94
619,DET,PHI,W,H,54,95,44,72,10,23,18,21,136
620,PHI,DET,L,H,43,88,29,54,14,34,6,7,106
621,BRK,POR,L,H,45,86,31,56,14,30,12,17,116
622,POR,BRK,W,H,49,86,33,61,16,25,16,22,130
623,MIN,SAS,L,H,35,89,31,73,4,16,16,22,90
624,SAS,MIN,W,H,38,94,32,70,6,24,15,24,97
625,ATL,CLE,L,H,49,91,39,65,10,26,22,30,130
626,CLE,ATL,W,H,47,86,22,40,25,46,16,20,135
627,DAL,MEM,W,H,39,82,34,55,5,27,21,27,104
628,MEM,DAL,L,H,38,82,29,54,9,28,15,22,100
629,BOS,LAL,W,H,43,84,33,51,10,33,19,25,115
630,LAL,BOS,L,H,37,87,31,63,6,24,15,20,95
631,LAC,MIL,L,H,36,64,28,45,8,19,21,36,101
632,MIL,LAC,W,H,44,80,34,55,10,25,14,15,112
633,NOP,SAS,L,H,35,91,27,66,8,25,20,24,98
634,SAS,NOP,W,H,40,95,34,68,6,27,15,25,101
635,MIA,ORL,L,H,35,91,27,63,8,28,21,25,99
636,ORL,MIA,W,H,45,90,40,73,5,17,15,19,110
637,NYK,PHI,L,H,33,84,26,63,7,21,29,33,102
638,PHI,NYK,W,H,36,83,27,55,9,28,24,31,105
639,OKC,PHO,L,H,37,87,28,52,9,35,28,35,111
640,PHO,OKC,W,H,44,89,39,68,5,21,25,31,118
641,BRK,UTA,L,H,36,89,29,59,7,30,18,24,97
642,UTA,BRK,W,H,38,74,26,48,12,26,24,34,112
643,TOR,WAS,W,H,41,81,30,56,11,25,21,27,114
644,WAS,TOR,L,H,34,92,24,62,10,30,28,32,106
645,CHI,GSW,W,H,36,82,31,63,5,19,17,21,94
646,GSW,CHI,L,H,34,88,28,58,6,30,13,14,87
647,CHO,PHO,L,H,35,89,25,55,10,34,23,28,103
648,PHO,CHO,W,H,46,77,39,58,7,19,21,25,120
649,OKC,POR,L,H,34,86,23,57,11,29,30,32,109
650,POR,OKC,W,H,39,79,29,54,10,25,26,35,114
651,ATL,DAL,W,H,36,64,26,43,10,21,18,24,100
652,DAL,ATL,L,H,35,77,21,44,14,33,11,13,95
653,BOS,CLE,W,H,36,78,23,47,13,31,18,23,103
654,CLE,BOS,L,H,37,91,27,58,10,33,15,22,99
655,HOU,LAC,W,H,37,87,17,35,20,52,28,33,122
656,LAC,HOU,L,H,42,94,30,60,12,34,7,13,103
657,MIA,PHI,W,H,49,90,36,60,13,30,14,21,125
658,PHI,MIA,L,H,37,85,31,68,6,17,18,22,98
659,DEN,MIL,W,H,41,84,31,51,10,33,18,20,110
660,MIL,DEN,L,H,38,83,29,65,9,18,13,15,98
661,DET,NOP,L,H,40,103,37,80,3,23,3,17,86
662,NOP,DET,W,H,39,78,30,53,9,25,22,23,109
663,NYK,ORL,W,H,34,81,26,52,8,29,25,31,101
664,ORL,NYK,L,H,34,83,29,58,5,25,17,22,90
665,BRK,SAC,W,H,34,74,23,46,11,28,30,36,109
666,SAC,BRK,L,H,35,81,24,59,11,22,19,22,100
667,IND,SAS,L,H,37,81,30,58,7,23,18,25,99
668,SAS,IND,W,H,35,74,26,45,9,29,21,24,100
669,TOR,WAS,L,H,33,90,26,70,7,20,23,26,96
670,WAS,TOR,W,H,40,84,31,59,9,25,16,19,105
671,MIN,UTA,W,H,39,78,31,62,8,16,21,26,107
672,UTA,MIN,L,H,35,90,31,71,4,19,6,11,80
673,CHI,DEN,L,H,44,96,34,70,10,26,9,10,107
674,DEN,CHI,W,H,45,80,32,50,13,30,22,24,125
675,DET,POR,W,H,45,104,38,79,7,25,23,31,120
676,POR,DET,L,H,44,84,34,59,10,25,15,22,113
677,CHO,LAL,W,H,38,85,22,46,16,39,17,24,109
678,LAL,CHO,L,H,41,84,29,52,12,32,10,13,104
679,MEM,PHO,W,H,48,86,36,61,12,25,22,29,130
680,PHO,MEM,L,H,43,83,36,62,7,21,19,24,112
681,OKC,UTA,W,H,39,76,24,54,15,22,16,23,109
682,UTA,OKC,L,H,43,93,34,71,9,22,11,13,106
683,GSW,WAS,L,H,39,84,31,55,8,29,22,27,108
684,WAS,GSW,W,H,41,91,29,63,12,28,18,20,112
685,ATL,BOS,W,H,46,95,40,70,6,25,16,20,114
686,BOS,ATL,L,H,34,87,24,53,10,34,20,25,98
687,CLE,MIL,W,H,35,70,25,42,10,28,22,26,102
688,MIL,CLE,L,H,37,83,26,53,11,30,10,16,95
689,DAL,MIA,W,H,33,76,24,58,9,18,21,23,96
690,MIA,DAL,L,H,37,83,28,57,9,26,6,13,89
691,HOU,IND,L,H,32,88,22,43,10,45,34,42,108
692,IND,HOU,W,H,41,91,28,61,13,30,22,25,117
693,NYK,TOR,L,H,33,73,24,49,9,24,16,19,91
694,TOR,NYK,W,H,33,78,26,52,7,26,19,23,92
695,GSW,PHI,W,H,40,89,34,60,6,29,33,39,119
696,PHI,GSW,L,H,37,82,27,48,10,34,24,27,108
697,MIN,SAC,W,H,40,95,32,72,8,23,14,20,102
698,SAC,MIN,L,H,36,82,30,65,6,17,10,15,88
699,DEN,MEM,L,H,37,84,26,50,11,34,13,17,98
700,MEM,DEN,W,H,36,80,25,47,11,33,22,25,105
701,BOS,DET,W,H,34,85,22,50,12,35,24,30,104
702,DET,BOS,L,H,35,81,23,48,12,33,16,35,98
703,CHO,LAC,L,H,38,80,20,40,18,40,27,30,121
704,LAC,CHO,W,H,45,97,35,65,10,32,24,34,124
705,LAL,SAS,L,H,40,87,33,65,7,22,11,18,98
706,SAS,LAL,W,H,49,94,39,73,10,21,11,13,119
707,MIL,PHO,W,H,39,76,33,56,6,20,16,18,100
708,PHO,MIL,L,H,40,83,35,69,5,14,11,16,96
709,NOP,OKC,L,H,36,80,28,59,8,21,30,37,110
710,OKC,NOP,W,H,42,88,36,67,6,21,28,37,118
711,POR,TOR,L,H,35,79,26,58,9,21,27,35,106
712,TOR,POR,W,H,42,78,35,58,7,20,21,27,112
713,UTA,WAS,W,H,34,72,23,48,11,24,23,32,102
714,WAS,UTA,L,H,37,87,29,65,8,22,10,13,92
715,CHI,CLE,W,H,46,93,31,63,15,30,10,16,117
716,CLE,CHI,L,H,37,80,23,43,14,37,11,15,99
717,DAL,NOP,W,H,36,78,24,52,12,26,12,16,96
718,NOP,DAL,L,H,31,78,26,54,5,24,16,25,83
719,BRK,GSW,L,H,38,94,30,66,8,28,11,17,95
720,GSW,BRK,W,H,42,100,31,69,11,31,17,22,112
721,HOU,MIN,W,H,44,94,22,36,22,58,32,42,142
722,MIN,HOU,L,H,49,94,40,68,9,26,23,28,130
723,IND,MIA,L,H,34,85,30,73,4,12,23,26,95
724,MIA,IND,W,H,38,78,25,47,13,31,24,31,113
725,NYK,PHI,W,H,43,91,37,70,6,21,18,23,110
726,PHI,NYK,L,H,40,95,33,64,7,31,22,27,109
727,ATL,ORL,L,H,32,85,24,60,8,25,14,26,86
728,ORL,ATL,W,H,37,81,29,54,8,27,23,24,105
729,CHO,SAC,W,H,34,85,20,47,14,38,17,18,99
730,SAC,CHO,L,H,31,79,20,51,11,28,12,15,85
731,ATL,MIA,L,H,30,79,24,59,6,20,24,36,90
732,MIA,ATL,W,H,40,99,23,62,17,37,11,13,108
733,CHI,PHO,W,H,46,98,34,72,12,26,24,31,128
734,PHO,CHI,L,H,49,93,41,69,8,24,15,25,121
735,BRK,DEN,L,H,41,83,31,53,10,30,17,31,109
736,DEN,BRK,W,H,49,97,35,66,14,31,17,24,129
737,IND,MEM,W,H,40,78,29,52,11,26,11,11,102
738,MEM,IND,L,H,35,84,26,57,9,27,13,23,92
739,LAC,SAS,L,H,35,79,28,56,7,23,20,24,97
740,SAS,LAC,W,H,35,82,26,56,9,26,26,30,105
741,MIL,UTA,L,H,32,74,25,56,7,18,24,29,95
742,UTA,MIL,W,H,37,74,29,51,8,23,27,30,109
743,DAL,MIN,L,H,35,83,27,50,8,33,6,9,84
744,MIN,DAL,W,H,41,78,36,65,5,13,10,14,97
745,LAL,OKC,L,H,40,101,33,66,7,35,6,14,93
746,OKC,LAL,W,H,44,97,34,73,10,24,12,17,110
747,PHI,WAS,W,H,43,87,33,58,10,29,24,30,120
748,WAS,PHI,L,H,38,90,33,66,5,24,31,40,112
749,BOS,TOR,L,H,33,78,21,40,12,38,19,22,97
750,TOR,BOS,W,H,40,81,35,66,5,15,22,29,107
751,CLE,NYK,W,H,46,87,31,49,15,38,12,15,119
752,NYK,CLE,L,H,42,101,34,75,8,26,12,17,104
753,CHO,DET,L,H,38,92,31,62,7,30,25,26,108
754,DET,CHO,W,H,44,107,29,70,15,37,11,12,114
755,GSW,LAC,W,H,43,81,30,56,13,25,24,26,123
756,LAC,GSW,L,H,38,93,27,65,11,28,26,37,113
757,HOU,NOP,W,H,45,91,25,40,20,51,19,24,129
758,NOP,HOU,L,H,36,86,30,55,6,31,21,26,99
759,ORL,POR,L,H,34,86,27,64,7,22,28,39,103
760,POR,ORL,W,H,41,81,32,63,9,18,21,27,112
761,DEN,SAC,L,H,39,88,27,53,12,35,10,14,100
762,SAC,DEN,W,H,46,88,39,74,7,14,17,19,116
763,BOS,CHI,L,H,36,77,22,40,14,37,17,20,103
764,CHI,BOS,W,H,38,90,32,65,6,25,22,22,104
765,IND,WAS,L,H,40,80,36,62,4,18,14,18,98
766,WAS,IND,W,H,43,83,28,54,15,29,10,15,111
767,BOS,PHI,W,H,38,80,25,52,13,28,27,36,116
768,PHI,BOS,L,H,44,93,36,62,8,31,12,18,108
769,BRK,MIL,L,H,46,88,32,52,14,36,19,23,125
770,MIL,BRK,W,H,50,88,43,73,7,15,22,32,129
771,CLE,IND,W,H,39,82,21,43,18,39,17,19,113
772,IND,CLE,L,H,40,86,28,62,12,24,12,14,104
773,DEN,MIN,L,H,38,94,27,60,11,34,12,18,99
774,MIN,DEN,W,H,41,86,35,68,6,18,24,28,112
775,DAL,DET,L,H,35,92,25,55,10,37,11,11,91
776,DET,DAL,W,H,36,82,30,63,6,19,20,22,98
777,GSW,SAC,W,H,41,84,28,48,13,36,14,21,109
778,SAC,GSW,L,H,33,89,26,65,7,24,13,17,86
779,HOU,MIA,L,H,36,87,23,47,13,40,24,31,109
780,MIA,HOU,W,H,44,84,31,49,13,35,16,24,117
781,ATL,LAC,L,H,32,79,25,53,7,26,13,19,84
782,LAC,ATL,W,H,37,79,23,42,14,37,11,12,99
783,MEM,NOP,L,H,33,89,27,56,6,33,19,25,91
784,NOP,MEM,W,H,37,75,29,57,8,18,13,22,95
785,NYK,OKC,L,H,41,86,30,65,11,21,12,14,105
786,OKC,NYK,W,H,41,88,29,65,12,23,22,31,116
787,ORL,SAS,L,H,30,76,26,58,4,18,15,19,79
788,SAS,ORL,W,H,42,89,34,58,8,31,15,19,107
789,LAL,PHO,L,H,35,93,26,67,9,26,22,28,101
790,PHO,LAL,W,H,49,88,39,64,10,24,29,34,137
791,CHO,TOR,L,H,32,76,19,38,13,38,8,9,85
792,TOR,CHO,W,H,32,84,20,52,12,32,14,19,90
793,POR,UTA,L,H,32,79,23,57,9,22,15,20,88
794,UTA,POR,W,H,42,81,31,59,11,22,16,23,111
795,CHI,TOR,W,H,35,73,28,56,7,17,28,35,105
796,TOR,CHI,L,H,35,77,30,57,5,20,19,24,94
797,LAL,SAC,L,H,38,83,26,54,12,29,8,15,96
798,SAC,LAL,W,H,36,73,29,49,7,24,18,25,97
799,CLE,MIN,W,H,44,86,31,47,13,39,15,22,116
800,MIN,CLE,L,H,42,86,33,63,9,23,15,19,108
801,BRK,MEM,L,H,38,82,26,45,12,37,15,18,103
802,MEM,BRK,W,H,39,77,30,55,9,22,25,27,112
803,CHO,PHI,L,H,34,78,23,47,11,31,20,26,99
804,PHI,CHO,W,H,41,86,29,53,12,33,11,17,105
805,BOS,DAL,W,H,40,81,24,47,16,34,15,18,111
806,DAL,BOS,L,H,35,77,26,50,9,27,19,25,98
807,DEN,GSW,W,H,48,88,24,47,24,41,12,16,132
808,GSW,DEN,L,H,45,92,37,60,8,32,12,13,110
809,IND,SAS,L,H,38,78,29,58,9,20,21,30,106
810,SAS,IND,W,H,40,87,33,72,7,15,23,27,110
811,MIA,ORL,L,H,39,83,33,61,6,22,23,27,107
812,ORL,MIA,W,H,44,90,36,76,8,14,20,29,116
813,DET,MIL,L,H,34,78,27,57,7,21,14,19,89
814,MIL,DET,W,H,40,79,34,58,6,21,16,16,102
815,NOP,PHO,W,H,37,78,29,50,8,28,28,35,110
816,PHO,NOP,L,H,40,93,32,70,8,23,20,24,108
817,ATL,POR,W,H,32,83,24,55,8,28,37,48,109
818,POR,ATL,L,H,37,103,21,61,16,42,14,25,104
819,LAC,UTA,W,H,36,81,27,56,9,25,7,11,88
820,UTA,LAC,L,H,28,87,24,64,4,23,12,18,72
821,OKC,WAS,L,H,34,96,27,62,7,34,23,30,98
822,WAS,OKC,W,H,42,73,29,53,13,20,23,28,120
823,CHI,MIN,L,H,35,84,25,59,10,25,9,13,89
824,MIN,CHI,W,H,44,81,38,57,6,24,23,26,117
825,NYK,SAS,W,H,34,68,25,54,9,14,17,21,94
826,SAS,NYK,L,H,33,91,27,62,6,29,18,22,90
827,NOP,SAC,L,H,34,82,21,51,13,31,18,21,99
828,SAC,NOP,W,H,35,78,24,47,11,31,24,27,105
829,DET,TOR,W,H,36,84,28,53,8,31,22,29,102
830,TOR,DET,L,H,38,75,30,59,8,16,17,25,101
831,CHO,LAC,L,H,37,85,24,48,13,37,15,20,102
832,LAC,CHO,W,H,40,85,26,51,14,34,13,20,107
833,CLE,DEN,W,H,46,84,31,54,15,30,18,22,125
834,DEN,CLE,L,H,39,97,27,60,12,37,19,22,109
835,DAL,ORL,W,H,45,91,28,56,17,35,5,6,112
836,ORL,DAL,L,H,32,82,29,59,3,23,13,18,80
837,HOU,PHO,W,H,42,85,24,49,18,36,31,39,133
838,PHO,HOU,L,H,37,94,29,72,8,22,20,26,102
839,IND,MIL,L,H,35,73,25,51,10,22,20,24,100
840,MIL,IND,W,H,35,73,18,42,17,31,29,37,116
841,GSW,OKC,W,H,46,87,33,56,13,31,25,35,130
842,OKC,GSW,L,H,40,83,34,59,6,24,28,36,114
843,MIA,PHI,L,H,39,85,32,61,7,24,24,28,109
844,PHI,MIA,W,H,39,86,30,61,9,25,30,38,117
845,BOS,UTA,W,H,42,71,29,41,13,30,15,23,112
846,UTA,BOS,L,H,35,86,27,55,8,31,26,30,104
847,BRK,MIA,L,H,35,81,27,61,8,20,21,28,99
848,MIA,BRK,W,H,41,92,34,69,7,23,19,21,108
849,DET,SAS,L,H,39,92,34,75,5,17,9,13,92
850,SAS,DET,W,H,41,82,32,63,9,19,12,15,103
851,GSW,MEM,W,H,39,77,24,44,15,33,29,38,122
852,MEM,GSW,L,H,34,87,25,61,9,26,30,37,107
853,LAL,MIL,W,H,39,75,24,44,15,31,29,35,122
854,MIL,LAL,L,H,40,76,32,48,8,28,26,31,114
855,MIN,NOP,L,H,38,82,32,55,6,27,24,32,106
856,NOP,MIN,W,H,45,75,33,50,12,25,20,27,122
857,DEN,NYK,W,H,54,95,38,63,16,32,7,10,131
858,NYK,DEN,L,H,52,93,36,55,16,38,3,5,123
859,CHI,PHO,L,H,37,86,32,67,5,19,18,22,97
860,PHO,CHI,W,H,48,95,40,76,8,19,11,13,115
861,ATL,SAC,L,H,36,71,25,41,11,30,24,31,107
862,SAC,ATL,W,H,38,80,20,44,18,36,14,21,108
863,IND,WAS,L,H,45,92,41,71,4,21,13,15,107
864,WAS,IND,W,H,41,88,31,59,10,29,20,30,112
865,CHO,HOU,L,H,37,85,29,59,8,26,13,14,95
866,HOU,CHO,W,H,39,87,26,47,13,40,16,20,107
867,DAL,UTA,W,H,44,87,39,67,5,20,19,25,112
868,UTA,DAL,L,H,39,85,26,56,13,29,14,17,105
869,CLE,OKC,L,H,38,79,28,58,10,21,23,30,109
870,OKC,CLE,W,H,50,106,42,79,8,27,10,13,118
871,ORL,PHI,L,H,41,84,31,63,10,21,19,24,111
872,PHI,ORL,W,H,40,95,29,67,11,28,21,27,112
873,BOS,POR,W,H,44,91,34,61,10,30,22,27,120
874,POR,BOS,L,H,39,77,30,51,9,26,24,31,111
875,ATL,DEN,W,H,47,93,39,66,8,27,15,18,117
876,DEN,ATL,L,H,40,100,27,56,13,44,13,21,106
877,BRK,WAS,L,H,38,91,29,58,9,33,25,36,110
878,WAS,BRK,W,H,40,97,31,72,9,25,25,33,114
879,DET,LAL,W,H,51,97,47,81,4,16,15,24,121
880,LAL,DET,L,H,37,86,31,63,6,23,22,26,102
881,CHI,GSW,L,H,37,92,33,68,4,24,14,19,92
882,GSW,CHI,W,H,48,85,33,57,15,28,12,13,123
883,CLE,IND,W,H,46,84,30,48,16,36,24,26,132
884,IND,CLE,L,H,41,82,28,57,13,25,22,26,117
885,MEM,PHO,W,H,35,72,21,48,14,24,26,34,110
886,PHO,MEM,L,H,29,87,24,64,5,23,28,34,91
887,MIA,MIL,W,H,41,86,30,53,11,33,13,18,106
888,MIL,MIA,L,H,33,71,27,56,6,15,16,28,88
889,MIN,TOR,W,H,39,80,32,61,7,19,27,30,112
890,TOR,MIN,L,H,42,79,31,51,11,28,14,20,109
891,NOP,UTA,L,H,35,77,30,53,5,24,19,25,94
892,UTA,NOP,W,H,48,88,34,56,14,32,17,21,127
893,LAC,NYK,W,H,45,92,35,67,10,25,19,28,119
894,NYK,LAC,L,H,46,92,38,65,8,27,15,18,115
895,PHI,SAS,L,H,34,84,21,50,13,34,22,29,103
896,SAS,PHI,W,H,39,74,28,52,11,22,22,25,111
897,BOS,SAC,L,H,29,73,19,41,10,32,24,27,92
898,SAC,BOS,W,H,42,84,32,59,10,25,14,15,108
899,BRK,CHO,L,H,39,86,27,50,12,36,17,21,107
900,CHO,BRK,W,H,40,102,33,76,7,26,24,29,111
901,DAL,POR,L,H,37,75,25,47,12,28,27,32,113
902,POR,DAL,W,H,42,86,31,58,11,28,19,24,114
903,HOU,ORL,W,H,44,89,28,51,16,38,24,36,128
904,ORL,HOU,L,H,42,88,36,63,6,25,14,20,104
905,ATL,UTA,L,H,33,74,27,57,6,17,23,32,95
906,UTA,ATL,W,H,49,80,39,54,10,26,12,18,120
907,DAL,DEN,L,H,34,79,26,53,8,26,11,17,87
908,DEN,DAL,W,H,42,84,31,56,11,28,15,16,110
909,DET,PHI,W,H,46,99,41,77,5,22,16,17,113
910,PHI,DET,L,H,36,85,31,57,5,28,19,28,96
911,IND,OKC,W,H,33,87,25,61,8,26,19,29,93
912,OKC,IND,L,H,34,88,27,60,7,28,15,21,90
913,MEM,SAS,W,H,32,81,28,62,4,19,21,25,89
914,SAS,MEM,L,H,30,82,26,63,4,19,10,18,74
915,MIA,MIN,W,H,45,86,30,58,15,28,10,14,115
916,MIN,MIA,L,H,43,80,38,69,5,11,22,28,113
917,NOP,PHO,W,H,42,92,33,66,9,26,18,22,111
918,PHO,NOP,L,H,40,93,35,66,5,27,21,25,106
919,LAL,NYK,W,H,44,102,36,74,8,28,25,31,121
920,NYK,LAL,L,H,37,82,30,61,7,21,26,33,107
921,CHI,SAC,W,H,43,81,37,62,6,19,20,31,112
922,SAC,CHI,L,H,41,79,30,51,11,28,14,16,107
923,LAC,TOR,L,H,42,90,29,55,13,35,12,18,109
924,TOR,LAC,W,H,41,84,31,60,10,24,26,29,118
925,CLE,WAS,W,H,49,92,30,54,19,38,23,28,140
926,WAS,CLE,L,H,50,99,38,70,12,29,23,26,135
927,BOS,LAC,W,H,37,88,21,36,16,52,17,20,107
928,LAC,BOS,L,H,35,84,25,55,10,29,22,28,102
929,BRK,TOR,L,H,32,76,19,42,13,34,18,21,95
930,TOR,BRK,W,H,40,87,35,68,5,19,18,20,103
931,OKC,POR,W,H,40,98,36,80,4,18,21,28,105
932,POR,OKC,L,H,35,87,25,59,10,28,19,21,99
933,ATL,ORL,W,H,41,78,31,50,10,28,21,27,113
934,ORL,ATL,L,H,27,78,20,51,7,27,25,28,86
935,DET,IND,L,H,31,75,25,58,6,17,16,20,84
936,IND,DET,W,H,44,91,37,67,7,24,10,15,105
937,MIA,PHI,W,H,48,82,36,60,12,22,17,23,125
938,PHI,MIA,L,H,35,84,29,61,6,23,26,31,102
939,MEM,MIN,W,H,32,77,22,49,10,28,33,39,107
940,MIN,MEM,L,H,35,84,25,58,10,26,19,24,99
941,CLE,NYK,W,H,41,84,25,44,16,40,13,18,111
942,NYK,CLE,L,H,39,86,27,55,12,31,14,28,104
943,MIL,PHO,W,H,52,82,45,65,7,17,26,35,137
944,PHO,MIL,L,H,38,91,27,63,11,28,25,30,112
945,GSW,SAC,L,H,36,87,21,43,15,44,19,24,106
946,SAC,GSW,W,H,43,88,36,65,7,23,16,19,109
947,DEN,SAS,L,H,41,92,31,66,10,26,5,10,97
948,SAS,DEN,W,H,45,79,35,58,10,21,21,26,121
949,CHO,UTA,L,H,35,82,22,49,13,33,15,18,98
950,UTA,CHO,W,H,38,81,25,48,13,33,16,24,105
951,NOP,WAS,L,H,37,84,32,67,5,17,12,22,91
952,WAS,NOP,W,H,38,83,28,52,10,31,19,22,105
953,BOS,LAL,W,H,39,82,26,47,13,35,22,28,113
954,LAL,BOS,L,H,37,94,23,56,14,38,19,26,107
955,BRK,IND,L,H,32,86,21,58,11,28,22,23,97
956,IND,BRK,W,H,37,86,29,66,8,20,24,31,106
957,DEN,MIL,W,H,40,89,31,61,9,28,32,44,121
958,MIL,DEN,L,H,45,83,36,59,9,24,18,23,117
959,DET,MIN,W,H,44,98,33,72,11,26,17,22,116
960,MIN,DET,L,H,44,89,39,72,5,17,15,19,108
961,CHI,HOU,L,H,48,100,40,75,8,25,13,18,117
962,HOU,CHI,W,H,44,98,28,55,16,43,17,25,121
963,MEM,OKC,L,H,40,83,37,64,3,19,19,22,102
964,OKC,MEM,W,H,38,80,25,54,13,26,25,33,114
965,ORL,TOR,W,H,37,80,32,66,5,14,23,32,102
966,TOR,ORL,L,H,34,87,24,59,10,28,16,21,94
967,DAL,POR,W,H,36,76,19,45,17,31,19,23,108
968,POR,DAL,L,H,40,88,31,58,9,30,15,20,104
969,PHO,SAC,W,H,32,77,20,48,12,29,29,35,105
970,SAC,PHO,L,H,38,85,28,58,10,27,17,22,103
971,ATL,HOU,W,H,44,85,36,55,8,30,17,23,113
972,HOU,ATL,L,H,35,93,22,42,13,51,25,33,108
973,GSW,LAC,W,H,52,99,38,65,14,34,15,18,133
974,LAC,GSW,L,H,40,80,30,55,10,25,30,39,120
975,PHI,SAS,L,H,30,88,21,63,9,25,17,23,86
976,SAS,PHI,W,H,38,89,32,68,6,21,20,27,102
977,LAL,WAS,L,H,40,87,28,48,12,39,16,22,108
978,WAS,LAL,W,H,44,96,32,63,12,33,16,21,116
979,BOS,TOR,W,H,36,87,24,51,12,36,25,30,109
980,TOR,BOS,L,H,41,78,33,47,8,31,14,25,104
981,BRK,NYK,L,H,37,88,32,63,5,25,11,16,90
982,NYK,BRK,W,H,35,99,29,72,6,27,19,31,95
983,CLE,MIN,W,H,48,89,33,52,15,37,14,22,125
984,MIN,CLE,L,H,41,94,34,73,7,21,8,10,97
985,DAL,PHI,W,H,40,86,30,60,10,26,23,28,113
986,PHI,DAL,L,H,35,77,29,55,6,22,19,26,95
987,DEN,MEM,L,H,32,80,23,55,9,25,26,35,99
988,MEM,DEN,W,H,45,92,31,62,14,30,15,20,119
989,DET,NOP,W,H,48,88,38,62,10,26,12,17,118
990,NOP,DET,L,H,41,82,36,61,5,21,11,14,98
991,CHO,GSW,L,H,39,88,30,57,9,31,24,26,111
992,GSW,CHO,W,H,47,96,26,48,21,48,11,14,126
993,ATL,MIA,L,H,34,86,27,60,7,26,18,21,93
994,MIA,ATL,W,H,45,93,33,61,12,32,14,19,116
995,CHI,OKC,W,H,49,81,43,66,6,15,24,30,128
996,OKC,CHI,L,H,38,100,28,63,10,37,14,17,100
997,IND,ORL,W,H,33,69,24,49,9,20,23,26,98
998,ORL,IND,L,H,31,77,25,53,6,24,20,28,88
999,LAC,PHO,W,H,44,85,39,66,5,19,31,38,124
1000,PHO,LAC,L,H,39,96,32,76,7,20,29,35,114
1001,MIL,BOS,L,A,37,84,31,61,6,23,14,17,94
1002,BOS,MIL,W,A,41,91,29,54,12,37,18,26,112
1003,CHI,BRK,W,A,41,95,27,65,14,30,16,21,112
1004,BRK,CHI,L,A,28,86,25,53,3,33,14,18,73
1005,TOR,CLE,W,A,40,86,32,60,8,26,10,16,98
1006,CLE,TOR,L,A,28,76,18,39,10,37,17,24,83
1007,LAL,GSW,L,A,41,93,37,76,4,17,8,14,94
1008,GSW,LAL,W,A,41,90,29,54,12,36,15,22,109
1009,MIN,HOU,L,A,48,91,37,68,11,23,11,15,118
1010,HOU,MIN,W,A,45,97,26,41,19,56,14,22,123
1011,IND,ATL,W,A,39,82,29,58,10,24,16,19,104
1012,ATL,IND,L,A,30,72,19,43,11,29,15,19,86
1013,SAC,LAC,L,A,40,81,35,70,5,11,10,14,95
1014,LAC,SAC,W,A,43,83,33,55,10,28,19,25,115
1015,MEM,DAL,L,A,33,84,25,59,8,25,19,22,93
1016,DAL,MEM,W,A,33,75,24,41,9,34,25,31,100
1017,WAS,MIA,L,A,42,87,35,61,7,26,11,14,102
1018,MIA,WAS,W,A,46,88,38,64,8,24,10,12,110
1019,PHI,NYK,L,A,46,93,39,70,7,23,14,20,113
1020,NYK,PHI,W,A,41,83,32,61,9,22,23,32,114
1021,OKC,DEN,L,A,43,101,35,76,8,25,11,17,105
1022,DEN,OKC,W,A,39,85,32,60,7,25,26,32,111
1023,ORL,DET,W,A,42,87,29,62,13,25,16,17,113
1024,DET,ORL,L,A,41,106,30,70,11,36,16,28,109
1025,POR,NOP,L,A,41,85,28,55,13,30,5,13,100
1026,NOP,POR,W,A,40,90,32,66,8,24,15,21,103
1027,UTA,SAS,W,A,39,77,29,51,10,26,13,20,101
1028,SAS,UTA,L,A,39,86,31,65,8,21,11,13,97
1029,CHO,ATL,L,A,29,88,26,65,3,23,15,19,76
1030,ATL,CHO,W,A,41,79,34,52,7,27,14,18,103
1031,DEN,DAL,W,A,41,84,23,42,18,42,9,14,109
1032,DAL,DEN,L,A,35,88,23,48,12,40,9,11,91
1033,NOP,LAL,L,A,37,79,30,57,7,22,15,20,96
1034,LAL,NOP,W,A,42,88,34,66,8,22,16,23,108
1035,OKC,MIN,W,A,37,86,30,64,7,22,19,25,100
1036,MIN,OKC,L,A,38,86,33,66,5,20,17,25,98
1037,SAC,PHO,W,A,43,83,34,64,9,19,34,43,129
1038,PHO,SAC,L,A,41,109,33,79,8,30,14,24,104
1039,BRK,BOS,L,A,31,86,23,55,8,31,35,39,105
1040,BOS,BRK,W,A,41,91,27,53,14,38,18,21,114
1041,ORL,CHI,L,A,29,84,24,57,5,27,12,16,75
1042,CHI,ORL,W,A,48,89,36,63,12,26,14,16,122
1043,WAS,DET,W,A,42,83,35,64,7,19,14,16,105
1044,DET,WAS,L,A,43,94,33,68,10,26,5,5,101
1045,UTA,GSW,W,A,41,92,28,57,13,35,10,15,105
1046,GSW,UTA,L,A,39,80,30,55,9,25,12,17,99
1047,LAC,HOU,W,A,46,91,36,65,10,26,23,28,125
1048,HOU,LAC,L,A,33,84,24,44,9,40,21,27,96
1049,MIA,CLE,W,A,44,95,32,62,12,33,24,34,124
1050,CLE,MIA,L,A,44,89,30,54,14,35,19,22,121
1051,MIL,CHO,W,A,35,78,19,51,16,27,3,5,89
1052,CHO,MIL,L,A,33,81,28,63,5,18,8,13,79
1053,PHI,IND,L,A,35,75,22,42,13,33,28,31,111
1054,IND,PHI,W,A,49,85,44,69,5,16,17,21,120
1055,SAS,POR,L,A,38,83,30,62,8,21,14,20,98
1056,POR,SAS,W,A,37,89,25,62,12,27,13,15,99
1057,CLE,ATL,L,A,45,98,26,52,19,46,16,20,125
1058,ATL,CLE,W,A,44,94,35,63,9,31,29,37,126
1059,OKC,DEN,W,A,40,96,34,71,6,25,20,22,106
1060,DEN,OKC,L,A,40,84,29,50,11,34,14,15,105
1061,MIN,LAL,L,A,40,80,37,65,3,15,26,31,109
1062,LAL,MIN,W,A,42,86,32,59,10,27,16,20,110
1063,MEM,DET,L,A,36,75,27,54,9,21,9,13,90
1064,DET,MEM,W,A,39,82,25,54,14,28,11,16,103
1065,TOR,NYK,W,A,40,77,30,46,10,31,20,23,110
1066,NYK,TOR,L,A,37,82,28,54,9,28,14,15,97
1067,PHO,DAL,W,A,44,80,36,61,8,19,28,32,124
1068,DAL,PHO,L,A,41,97,25,52,16,45,13,19,111
1069,SAC,HOU,L,A,47,94,38,63,9,31,25,30,128
1070,HOU,SAC,W,A,45,80,27,37,18,43,27,31,135
1071,CHI,BRK,L,A,40,90,29,66,11,24,15,17,106
1072,BRK,CHI,W,A,39,92,29,61,10,31,19,24,107
1073,CHO,BOS,L,A,38,84,29,56,9,28,29,32,114
1074,BOS,CHO,W,A,45,87,28,48,17,39,14,17,121
1075,NOP,GSW,L,A,42,86,37,65,5,21,12,19,101
1076,GSW,NOP,W,A,49,96,39,63,10,33,15,16,123
1077,ORL,IND,L,A,41,84,27,54,14,30,16,22,112
1078,IND,ORL,W,A,51,86,40,64,11,22,14,19,127
1079,PHI,MIL,L,A,27,77,19,46,8,31,20,23,82
1080,MIL,PHI,W,A,35,79,29,52,6,27,14,20,90
1081,UTA,POR,L,A,31,78,25,59,6,19,18,24,86
1082,POR,UTA,W,A,37,91,24,61,13,30,14,16,101
1083,SAS,LAC,L,A,34,80,26,58,8,22,11,14,87
1084,LAC,SAS,W,A,42,84,36,62,6,22,8,14,98
1085,WAS,MIA,L,A,39,81,31,59,8,22,17,22,103
1086,MIA,WAS,W,A,37,80,30,62,7,18,25,36,106
1087,CLE,ATL,L,A,39,81,30,45,9,36,13,17,100
1088,ATL,CLE,W,A,45,89,29,52,16,37,8,8,114
1089,SAS,DAL,W,A,40,96,31,68,9,28,13,22,102
1090,DAL,SAS,L,A,38,88,30,62,8,26,5,8,89
1091,NOP,DEN,L,A,47,99,44,76,3,23,9,13,106
1092,DEN,NOP,W,A,43,78,30,46,13,32,23,32,122
1093,HOU,DET,L,A,36,87,20,36,16,51,21,28,109
1094,DET,HOU,W,A,46,108,37,82,9,26,13,16,114
1095,SAC,LAL,L,A,38,75,30,55,8,20,10,13,94
1096,LAL,SAC,W,A,38,86,34,62,4,24,18,25,98
1097,NYK,MEM,L,A,38,88,32,60,6,28,6,13,88
1098,MEM,NYK,W,A,38,75,23,48,15,27,10,12,101
1099,PHO,OKC,W,A,43,83,35,65,8,18,26,31,120
1100,OKC,PHO,L,A,34,92,27,62,7,30,24,33,99
1101,TOR,MIA,W,A,35,85,26,65,9,20,17,24,96
1102,MIA,TOR,L,A,33,83,25,60,8,23,20,29,94
1103,UTA,MIN,W,A,45,75,31,50,14,25,16,22,120
1104,MIN,UTA,L,A,39,79,32,63,7,16,28,28,113
1105,BOS,ATL,L,A,37,90,22,47,15,43,27,34,116
1106,ATL,BOS,W,A,44,89,33,66,11,23,24,34,123
1107,MIL,IND,L,A,33,71,22,47,11,24,12,14,89
1108,IND,MIL,W,A,38,80,30,55,8,25,20,26,104
1109,WAS,NYK,W,A,36,74,22,40,14,34,20,28,106
1110,NYK,WAS,L,A,40,95,33,75,7,20,16,21,103
1111,ORL,BRK,W,A,42,90,33,65,9,25,22,26,115
1112,BRK,ORL,L,A,40,87,29,57,11,30,16,22,107
1113,PHI,CHI,L,A,33,91,26,58,7,33,17,22,90
1114,CHI,PHI,W,A,39,91,31,66,8,25,16,17,102
1115,POR,MIN,W,A,35,81,21,48,14,33,21,26,105
1116,MIN,POR,L,A,38,87,34,69,4,18,18,20,98
1117,CLE,BOS,W,A,43,92,32,56,11,36,17,18,114
1118,BOS,CLE,L,A,33,81,26,48,7,33,18,29,91
1119,MIA,CHO,W,A,40,84,19,44,21,40,11,12,112
1120,CHO,MIA,L,A,35,78,27,53,8,25,21,24,99
1121,TOR,DET,W,A,41,87,31,57,10,30,13,15,105
1122,DET,TOR,L,A,42,81,35,60,7,21,11,18,102
1123,HOU,DEN,W,A,37,87,27,53,10,34,26,38,110
1124,DEN,HOU,L,A,41,104,34,66,7,38,15,18,104
1125,LAC,DAL,W,A,38,75,26,44,12,31,24,31,112
1126,DAL,LAC,L,A,38,86,27,55,11,31,14,18,101
1127,OKC,MEM,W,A,37,85,23,54,14,31,15,24,103
1128,MEM,OKC,L,A,37,78,28,52,9,26,17,21,100
1129,PHO,GSW,L,A,43,103,36,76,7,27,18,26,111
1130,GSW,PHO,W,A,45,89,32,59,13,30,17,24,120
1131,SAS,LAL,L,A,39,89,26,54,13,35,4,6,95
1132,LAL,SAS,W,A,42,86,35,72,7,14,11,14,102
1133,ORL,CLE,L,A,33,86,22,53,11,33,25,26,102
1134,CLE,ORL,W,A,44,82,26,46,18,36,16,21,122
1135,MIN,GSW,L,A,41,96,37,77,4,19,21,26,107
1136,GSW,MIN,W,A,44,84,30,52,14,32,19,24,121
1137,TOR,IND,L,A,34,76,29,53,5,23,17,19,90
1138,IND,TOR,W,A,39,89,27,64,12,25,18,18,108
1139,NOP,DEN,L,A,51,100,37,68,14,32,15,17,131
1140,DEN,NOP,W,A,53,99,40,69,13,30,15,21,134
1141,NYK,CHI,W,A,42,89,36,66,6,23,10,16,100
1142,CHI,NYK,L,A,32,85,26,58,6,27,21,23,91
1143,OKC,MIL,W,A,40,84,31,56,9,28,21,25,110
1144,MIL,OKC,L,A,29,81,26,63,3,18,18,26,79
1145,PHI,BRK,L,A,43,97,31,59,12,38,20,27,118
1146,BRK,PHI,W,A,48,75,32,44,16,31,29,33,141
1147,SAC,DAL,W,A,36,81,24,59,12,22,14,17,98
1148,DAL,SAC,L,A,32,80,20,37,12,43,11,14,87
1149,SAS,MEM,W,A,35,80,24,59,11,21,14,18,95
1150,MEM,SAS,L,A,35,89,27,64,8,25,11,18,89
1151,UTA,POR,W,A,39,74,26,51,13,23,15,19,106
1152,POR,UTA,L,A,33,83,27,57,6,26,15,17,87
1153,WAS,CHO,W,A,43,85,26,51,17,34,15,18,118
1154,CHO,WAS,L,A,40,79,28,45,12,34,19,22,111
1155,POR,MIN,L,A,38,86,27,54,11,32,22,25,109
1156,MIN,POR,W,A,41,84,37,75,4,9,24,28,110
1157,BRK,ATL,W,A,32,82,22,49,10,33,17,20,91
1158,ATL,BRK,L,A,30,80,23,56,7,24,15,23,82
1159,IND,CLE,L,A,48,105,32,64,16,41,18,20,130
1160,CLE,IND,W,A,47,95,29,52,18,43,23,33,135
1161,WAS,GSW,L,A,43,92,33,65,10,27,19,25,115
1162,GSW,WAS,W,A,50,88,34,52,16,36,23,26,139
1163,MEM,LAL,L,A,40,80,27,50,13,30,10,14,103
1164,LAL,MEM,W,A,40,85,33,66,7,19,21,27,108
1165,MIA,DEN,L,A,42,87,29,60,13,27,16,21,113
1166,DEN,MIA,W,A,44,87,39,67,5,20,23,27,116
1167,MIL,DAL,L,A,39,77,27,43,12,34,15,18,105
1168,DAL,MIL,W,A,38,73,24,37,14,36,19,20,109
1169,NOP,CHI,L,A,33,81,23,51,10,30,34,35,110
1170,CHI,NOP,W,A,45,92,32,66,13,26,14,18,117
1171,NYK,BOS,L,A,33,85,26,60,7,25,21,25,94
1172,BOS,NYK,W,A,40,72,28,35,12,37,18,26,110
1173,OKC,CHO,L,A,39,84,27,53,12,31,11,12,101
1174,CHO,OKC,W,A,37,77,26,47,11,30,28,32,113
1175,PHO,HOU,L,A,42,100,34,66,8,34,24,29,116
1176,HOU,PHO,W,A,47,100,33,62,14,38,15,23,123
1177,UTA,SAS,L,A,43,89,34,65,9,24,8,13,103
1178,SAS,UTA,W,A,40,77,30,58,10,19,19,22,109
1179,TOR,PHI,W,A,46,85,40,66,6,19,15,19,113
1180,PHI,TOR,L,A,36,80,25,44,11,36,22,25,105
1181,ORL,BRK,L,A,45,91,35,66,10,25,11,15,111
1182,BRK,ORL,W,A,50,94,42,63,8,31,13,16,121
1183,CHI,ATL,W,A,40,85,28,55,12,30,14,14,106
1184,ATL,CHI,L,A,40,90,29,62,11,28,13,17,104
1185,LAL,LAC,L,A,39,90,33,67,6,23,20,30,104
1186,LAC,LAL,W,A,38,69,27,44,11,25,28,34,115
1187,SAC,MIN,W,A,44,78,33,59,11,19,24,33,123
1188,MIN,SAC,L,A,39,87,30,60,9,27,30,38,117
1189,POR,PHO,W,A,43,92,28,55,15,37,29,31,130
1190,PHO,POR,L,A,44,84,41,74,3,10,26,32,117
1191,ORL,BOS,L,A,40,98,28,68,12,30,24,25,116
1192,BOS,ORL,W,A,38,84,26,51,12,33,29,34,117
1193,DEN,CHO,L,A,45,90,29,57,16,33,8,11,114
1194,CHO,DEN,W,A,40,86,23,50,17,36,25,30,122
1195,PHI,CLE,L,A,40,82,29,49,11,33,14,19,105
1196,CLE,PHI,W,A,50,95,37,66,13,29,9,16,122
1197,HOU,GSW,L,A,34,91,22,54,12,37,18,23,98
1198,GSW,HOU,W,A,43,95,32,63,11,32,10,14,107
1199,MEM,DAL,W,A,35,75,24,48,11,27,18,20,99
1200,DAL,MEM,L,A,29,76,17,42,12,34,20,25,90
1201,NYK,MIA,W,A,38,80,32,64,6,16,16,17,98
1202,MIA,NYK,L,A,34,83,26,50,8,33,18,25,94
1203,MIL,DET,W,A,35,84,21,48,14,36,24,34,108
1204,DET,MIL,L,A,44,97,37,67,7,30,10,16,105
1205,SAC,NOP,L,A,35,90,29,70,6,20,13,17,89
1206,NOP,SAC,W,A,46,95,36,62,10,33,15,19,117
1207,SAS,OKC,W,A,37,85,28,58,9,27,17,27,100
1208,OKC,SAS,L,A,33,81,27,60,6,21,23,27,95
1209,TOR,IND,W,A,37,82,23,55,14,27,23,35,111
1210,IND,TOR,L,A,36,87,25,61,11,26,17,21,100
1211,WAS,UTA,L,A,35,87,30,70,5,17,13,16,88
1212,UTA,WAS,W,A,33,72,23,47,10,25,19,31,95
1213,CLE,CHI,L,A,37,83,27,56,10,27,9,16,93
1214,CHI,CLE,W,A,38,90,26,65,12,25,11,18,99
1215,DET,BRK,W,A,36,86,29,68,7,18,11,17,90
1216,BRK,DET,L,A,35,92,25,61,10,31,9,12,89
1217,MIN,LAL,W,A,43,89,33,68,10,21,23,30,119
1218,LAL,MIN,L,A,40,84,31,57,9,27,15,16,104
1219,PHO,LAC,L,A,49,92,42,69,7,23,13,24,118
1220,LAC,PHO,W,A,44,80,32,58,12,22,24,34,124
1221,POR,HOU,W,A,43,90,30,57,13,33,18,22,117
1222,HOU,POR,L,A,40,91,32,57,8,34,19,23,107
1223,MIL,BOS,W,A,41,78,33,56,8,22,13,17,103
1224,BOS,MIL,L,A,35,88,23,51,12,37,18,23,100
1225,WAS,LAC,L,A,46,93,33,59,13,34,19,29,124
1226,LAC,WAS,W,A,47,83,35,53,12,30,27,37,133
1227,MEM,IND,W,A,41,88,29,56,12,32,16,18,110
1228,IND,MEM,L,A,37,85,27,60,10,25,13,15,97
1229,NOP,DAL,W,A,42,84,30,54,12,30,25,33,121
1230,DAL,NOP,L,A,44,91,30,64,14,27,16,17,118
1231,NYK,MIA,L,A,33,89,28,64,5,25,17,21,88
1232,MIA,NYK,W,A,40,84,28,59,12,25,13,17,105
1233,ORL,OKC,L,A,39,97,30,67,9,30,19,27,106
1234,OKC,ORL,W,A,43,102,33,69,10,33,18,28,114
1235,PHI,ATL,L,A,36,87,25,48,11,39,9,11,92
1236,ATL,PHI,W,A,34,80,25,62,9,18,22,26,99
1237,UTA,SAC,W,A,42,79,29,48,13,31,15,19,112
1238,SAC,UTA,L,A,34,75,32,60,2,15,12,18,82
1239,SAS,GSW,L,A,34,83,25,59,9,24,21,26,98
1240,GSW,SAS,W,A,43,85,30,59,13,26,11,11,110
1241,TOR,CHO,L,A,38,83,27,52,11,31,19,24,106
1242,CHO,TOR,W,A,39,86,23,54,16,32,16,21,110
1243,PHO,ATL,L,A,35,96,28,65,7,31,14,24,91
1244,ATL,PHO,W,A,34,85,28,58,6,27,21,29,95
1245,PHI,BRK,W,A,39,91,29,58,10,33,18,21,106
1246,BRK,PHI,L,A,38,94,29,62,9,32,16,24,101
1247,MIL,CHO,W,A,46,74,32,44,14,30,12,17,118
1248,CHO,MIL,L,A,39,80,32,52,7,28,23,29,108
1249,MIA,DET,W,A,36,79,31,58,5,21,20,28,97
1250,DET,MIA,L,A,36,85,28,58,8,27,16,21,96
1251,HOU,GSW,L,A,33,85,28,54,5,31,35,39,106
1252,GSW,HOU,W,A,45,88,34,47,11,41,12,16,113
1253,MIN,IND,W,A,37,78,28,58,9,20,32,37,115
1254,IND,MIN,L,A,40,81,35,63,5,18,29,35,114
1255,WAS,LAL,W,A,48,94,42,71,6,23,17,25,119
1256,LAL,WAS,L,A,43,85,35,63,8,22,14,16,108
1257,POR,DEN,W,A,45,91,37,64,8,27,24,33,122
1258,DEN,POR,L,A,44,94,35,64,9,30,16,20,113
1259,OKC,DAL,W,A,37,85,31,62,6,23,12,14,92
1260,DAL,OKC,L,A,33,80,23,51,10,29,15,19,91
1261,NYK,DET,W,A,45,84,38,63,7,21,12,13,109
1262,DET,NYK,L,A,36,84,27,61,9,23,14,21,95
1263,SAC,MEM,W,A,31,67,25,42,6,25,23,30,91
1264,MEM,SAC,L,A,31,90,26,64,5,26,23,29,90
1265,SAS,CLE,W,A,41,86,34,60,7,26,14,17,103
1266,CLE,SAS,L,A,31,83,27,57,4,26,8,13,74
1267,TOR,ORL,W,A,49,83,39,68,10,15,23,35,131
1268,ORL,TOR,L,A,43,88,39,68,4,20,22,28,112
1269,UTA,NOP,W,A,41,85,26,58,15,27,11,18,108
1270,NOP,UTA,L,A,37,80,27,55,10,25,16,24,100
1271,BRK,ATL,W,A,38,86,32,64,6,22,25,30,107
1272,ATL,BRK,L,A,34,98,29,71,5,27,19,32,92
1273,MIA,BOS,L,A,41,91,34,62,7,29,19,24,108
1274,BOS,MIA,W,A,41,77,33,53,8,24,22,25,112
1275,PHO,CHO,L,A,41,81,35,65,6,16,18,22,106
1276,CHO,PHO,W,A,42,87,28,57,14,30,22,24,120
1277,NOP,DEN,W,A,48,97,39,70,9,27,10,12,115
1278,DEN,NOP,L,A,36,95,30,70,6,25,12,14,90
1279,MEM,GSW,L,A,38,85,30,56,8,29,10,15,94
1280,GSW,MEM,W,A,39,71,22,40,17,31,11,15,106
1281,OKC,HOU,L,A,47,94,36,64,11,30,20,28,125
1282,HOU,OKC,W,A,50,79,30,40,20,39,17,21,137
1283,PHI,IND,L,A,35,88,21,47,14,41,10,14,94
1284,IND,PHI,W,A,38,89,31,72,7,17,24,29,107
1285,SAC,LAC,W,A,38,84,25,56,13,28,9,13,98
1286,LAC,SAC,L,A,32,78,22,49,10,29,23,28,97
1287,POR,LAL,W,A,36,89,24,61,12,28,13,18,97
1288,LAL,POR,L,A,33,84,28,63,5,21,10,17,81
1289,MIL,CHI,L,A,37,84,30,61,7,23,13,17,94
1290,CHI,MIL,W,A,46,85,36,64,10,21,7,10,109
1291,WAS,CLE,W,A,49,82,41,64,8,18,21,26,127
1292,CLE,WAS,L,A,41,83,29,50,12,33,21,27,115
1293,TOR,DAL,W,A,39,81,30,60,9,21,7,9,94
1294,DAL,TOR,L,A,31,82,24,54,7,28,17,20,86
1295,UTA,LAC,L,A,37,86,29,60,8,26,13,18,95
1296,LAC,UTA,W,A,38,84,31,57,7,27,25,28,108
1297,POR,MIN,W,A,45,71,34,49,11,22,11,17,112
1298,MIN,POR,L,A,37,76,35,66,2,10,24,32,100
1299,SAS,NYK,W,A,45,99,35,74,10,25,6,8,106
1300,NYK,SAS,L,A,41,87,38,77,3,10,13,15,98
1301,PHO,BOS,L,A,39,86,33,67,6,19,36,49,120
1302,BOS,PHO,W,A,44,94,30,53,14,41,28,35,130
1303,PHI,CHI,W,A,46,83,38,58,8,25,17,23,117
1304,CHI,PHI,L,A,37,91,27,67,10,24,23,31,107
1305,CLE,CHO,W,A,41,74,32,49,9,25,21,24,112
1306,CHO,CLE,L,A,38,90,28,52,10,38,19,24,105
1307,SAC,GSW,L,A,40,83,30,62,10,21,10,13,100
1308,GSW,SAC,W,A,44,89,34,58,10,31,16,18,114
1309,NOP,HOU,L,A,41,91,27,53,14,38,11,14,107
1310,HOU,NOP,W,A,44,93,30,54,14,39,15,20,117
1311,IND,DEN,L,A,48,95,35,71,13,24,8,11,117
1312,DEN,IND,W,A,39,82,32,55,7,27,40,43,125
1313,MIN,LAL,L,A,46,95,39,74,7,21,20,22,119
1314,LAL,MIN,W,A,46,88,32,65,14,23,24,28,130
1315,MIL,ATL,W,A,39,88,31,61,8,27,14,16,100
1316,ATL,MIL,L,A,34,83,26,61,8,22,21,24,97
1317,ORL,DET,W,A,47,91,35,65,12,26,9,13,115
1318,DET,ORL,L,A,34,96,32,74,2,22,17,20,87
1319,WAS,BRK,W,A,49,97,39,71,10,26,21,22,129
1320,BRK,WAS,L,A,43,82,40,67,3,15,19,26,108
1321,PHO,BRK,L,A,34,93,27,68,7,25,23,34,98
1322,BRK,PHO,W,A,43,95,35,66,8,29,32,42,126
1323,LAC,DAL,L,A,36,80,27,53,9,27,14,21,95
1324,DAL,LAC,W,A,38,82,29,56,9,26,12,18,97
1325,TOR,MIA,W,A,35,79,29,56,6,23,25,32,101
1326,MIA,TOR,L,A,32,82,26,59,6,23,14,23,84
1327,POR,NYK,W,A,39,80,28,59,11,21,21,29,110
1328,NYK,POR,L,A,36,88,31,66,5,22,18,20,95
1329,SAS,MEM,W,A,37,77,29,51,8,26,15,23,97
1330,MEM,SAS,L,A,34,78,24,49,10,29,12,15,90
1331,IND,BOS,L,A,38,87,27,59,11,28,13,19,100
1332,BOS,IND,W,A,43,84,32,57,11,27,12,14,109
1333,DET,CHI,L,A,39,88,32,68,7,20,10,17,95
1334,CHI,DET,W,A,47,80,36,57,11,23,12,19,117
1335,DEN,CLE,W,A,51,96,40,70,11,26,13,13,126
1336,CLE,DEN,L,A,43,85,28,48,15,37,12,14,113
1337,PHI,OKC,L,A,37,87,29,62,8,25,15,17,97
1338,OKC,PHI,W,A,48,88,44,72,4,16,22,30,122
1339,ORL,CHO,L,A,40,88,26,48,14,40,8,10,102
1340,CHO,ORL,W,A,42,90,33,63,9,27,16,18,109
1341,SAC,MIL,L,A,41,84,31,58,10,26,6,10,98
1342,MIL,SAC,W,A,43,81,27,46,16,35,14,19,116
1343,UTA,NYK,W,A,41,90,34,62,7,28,19,29,108
1344,NYK,UTA,L,A,38,80,29,59,9,21,16,18,101
1345,WAS,ATL,W,A,38,95,27,61,11,34,17,23,104
1346,ATL,WAS,L,A,34,86,26,61,8,25,24,29,100
1347,DET,BRK,L,A,40,92,35,69,5,23,11,16,96
1348,BRK,DET,W,A,38,88,28,59,10,29,12,19,98
1349,GSW,DAL,W,A,43,78,30,48,13,30,13,16,112
1350,DAL,GSW,L,A,33,92,22,58,11,34,10,12,87
1351,LAL,LAC,L,A,43,92,37,72,6,20,17,27,109
1352,LAC,LAL,W,A,45,84,30,51,15,33,28,32,133
1353,PHO,MIA,L,A,36,82,32,66,4,16,21,29,97
1354,MIA,PHO,W,A,42,96,31,69,11,27,17,23,112
1355,SAS,MIN,W,A,37,77,29,53,8,24,18,22,100
1356,MIN,SAS,L,A,32,72,25,57,7,15,22,25,93
1357,NOP,MEM,W,A,35,88,26,59,9,29,16,19,95
1358,MEM,NOP,L,A,32,79,23,44,9,35,9,13,82
1359,POR,MIL,L,A,35,83,31,62,4,21,16,26,90
1360,MIL,POR,W,A,38,90,31,74,7,16,10,12,93
1361,TOR,CHI,W,A,47,95,39,72,8,23,20,27,122
1362,CHI,TOR,L,A,42,90,28,53,14,37,22,27,120
1363,WAS,BOS,L,A,37,86,29,51,8,35,20,26,102
1364,BOS,WAS,W,A,40,93,30,60,10,33,20,28,110
1365,CHO,ATL,W,A,40,80,28,50,12,30,13,20,105
1366,ATL,CHO,L,A,37,84,25,47,12,37,4,10,90
1367,HOU,DEN,W,A,45,89,28,51,17,38,18,23,125
1368,DEN,HOU,L,A,44,86,32,57,12,29,24,26,124
1369,UTA,IND,L,A,40,88,34,63,6,25,14,20,100
1370,IND,UTA,W,A,38,87,28,67,10,20,21,23,107
1371,NYK,LAC,L,A,40,89,34,65,6,24,19,24,105
1372,LAC,NYK,W,A,43,87,33,56,10,31,18,24,114
1373,OKC,GSW,L,A,37,87,33,66,4,21,17,31,95
1374,GSW,OKC,W,A,40,83,25,50,15,33,16,21,111
1375,PHI,ORL,L,A,39,102,30,68,9,34,22,24,109
1376,ORL,PHI,W,A,35,94,31,71,4,23,38,46,112
1377,DAL,BRK,W,A,41,76,31,51,10,25,19,25,111
1378,BRK,DAL,L,A,31,72,18,41,13,31,29,38,104
1379,PHO,DET,L,A,35,99,29,77,6,22,19,30,95
1380,DET,PHO,W,A,40,92,28,67,12,25,20,30,112
1381,LAL,CLE,L,A,47,91,36,64,11,27,15,19,120
1382,CLE,LAL,W,A,45,85,32,49,13,36,22,27,125
1383,POR,MIA,W,A,42,83,29,57,13,26,18,24,115
1384,MIA,POR,L,A,41,88,32,58,9,30,13,20,104
1385,NOP,MIN,W,A,49,90,35,60,14,30,11,15,123
1386,MIN,NOP,L,A,44,86,35,61,9,25,12,17,109
1387,PHI,BOS,W,A,41,88,29,55,12,33,11,15,105
1388,BOS,PHI,L,A,34,84,28,55,6,29,25,29,99
1389,SAS,SAC,W,A,43,87,32,59,11,28,21,27,118
1390,SAC,SAS,L,A,41,83,34,73,7,10,13,17,102
1391,TOR,IND,W,A,45,91,33,64,12,27,14,16,116
1392,IND,TOR,L,A,33,80,27,57,6,23,19,26,91
1393,POR,ATL,W,A,44,87,36,69,8,18,17,19,113
1394,ATL,POR,L,A,32,88,25,62,7,26,26,32,97
1395,UTA,CHI,L,A,31,81,24,56,7,25,17,25,86
1396,CHI,UTA,W,A,38,80,31,61,7,19,12,14,95
1397,WAS,CHO,L,A,29,79,18,46,11,33,24,31,93
1398,CHO,WAS,W,A,35,82,26,58,9,24,19,27,98
1399,HOU,DEN,W,A,38,83,33,59,5,24,28,35,109
1400,DEN,HOU,L,A,38,89,28,58,10,31,19,30,105
1401,MIL,GSW,L,A,36,89,27,62,9,27,11,14,92
1402,GSW,MIL,W,A,45,75,33,52,12,23,15,19,117
1403,LAC,CLE,W,A,40,78,32,52,8,26,20,29,108
1404,CLE,LAC,L,A,32,83,27,56,5,27,9,13,78
1405,SAS,MEM,L,A,33,75,24,47,9,28,21,22,96
1406,MEM,SAS,W,A,32,76,19,46,13,30,27,31,104
1407,SAC,OKC,L,A,35,85,30,64,5,21,19,23,94
1408,OKC,SAC,W,A,41,82,31,56,10,26,18,25,110
1409,BRK,BOS,L,A,30,83,19,48,11,35,24,30,95
1410,BOS,BRK,W,A,34,85,27,56,7,29,23,29,98
1411,TOR,DET,W,A,30,78,21,51,9,27,18,20,87
1412,DET,TOR,L,A,29,83,26,63,3,20,14,21,75
1413,MIL,LAL,W,A,40,82,36,58,4,24,23,30,107
1414,LAL,MIL,L,A,38,84,27,55,11,29,16,26,103
1415,MIN,MIA,L,A,41,82,39,70,2,12,21,22,105
1416,MIA,MIN,W,A,50,85,42,59,8,26,15,19,123
1417,NOP,HOU,W,A,49,92,37,58,12,34,18,24,128
1418,HOU,NOP,L,A,37,91,24,51,13,40,25,32,112
1419,PHI,DAL,W,A,42,80,30,51,12,29,20,23,116
1420,DAL,PHI,L,A,30,87,25,64,5,23,9,17,74
1421,PHO,ORL,L,A,38,87,36,73,2,14,25,30,103
1422,ORL,PHO,W,A,42,96,35,73,7,23,18,21,109
1423,WAS,CHI,W,A,46,101,36,75,10,26,10,12,112
1424,CHI,WAS,L,A,44,88,37,61,7,27,12,18,107
1425,MEM,ATL,W,A,39,92,29,64,10,28,15,18,103
1426,ATL,MEM,L,A,29,71,21,44,8,27,25,34,91
1427,UTA,CLE,L,A,34,82,29,61,5,21,10,14,83
1428,CLE,UTA,W,A,36,86,27,53,9,33,10,19,91
1429,LAC,DEN,L,A,44,84,28,52,16,32,10,15,114
1430,DEN,LAC,W,A,46,86,31,58,15,28,22,26,129
1431,ORL,GSW,L,A,35,94,28,67,7,27,15,21,92
1432,GSW,ORL,W,A,50,87,40,61,10,26,12,23,122
1433,NYK,BRK,L,A,41,88,38,70,3,18,25,26,110
1434,BRK,NYK,W,A,41,86,31,54,10,32,29,35,121
1435,TOR,OKC,L,A,37,81,32,61,5,20,23,30,102
1436,OKC,TOR,W,A,47,88,33,63,14,25,15,19,123
1437,MIN,BOS,L,A,40,91,32,64,8,27,16,20,104
1438,BOS,MIN,W,A,43,79,30,46,13,33,18,21,117
1439,MEM,CHI,W,A,36,85,25,54,11,31,15,18,98
1440,CHI,MEM,L,A,34,91,23,63,11,28,12,15,91
1441,UTA,DET,W,A,36,77,23,49,13,28,12,16,97
1442,DET,UTA,L,A,36,86,33,73,3,13,8,12,83
1443,LAL,HOU,L,A,42,91,39,66,3,25,13,18,100
1444,HOU,LAL,W,A,50,91,32,48,18,43,21,32,139
1445,IND,CHO,W,A,39,73,27,45,12,28,8,9,98
1446,CHO,IND,L,A,32,80,29,57,3,23,10,13,77
1447,MIL,LAC,W,A,34,76,24,47,10,29,19,25,97
1448,LAC,MIL,L,A,35,75,30,51,5,24,21,29,96
1449,NOP,MIA,L,A,42,88,33,66,9,22,19,28,112
1450,MIA,NOP,W,A,44,87,28,52,16,35,16,19,120
1451,SAC,PHO,W,A,38,79,32,65,6,14,25,34,107
1452,PHO,SAC,L,A,43,107,37,82,6,25,9,14,101
1453,SAS,POR,L,A,42,88,31,62,11,26,11,15,106
1454,POR,SAS,W,A,38,80,29,58,9,22,25,28,110
1455,WAS,DAL,L,A,40,82,28,52,12,30,15,21,107
1456,DAL,WAS,W,A,40,79,26,47,14,32,18,25,112
1457,OKC,BRK,W,A,44,89,34,67,10,22,24,34,122
1458,BRK,OKC,L,A,33,71,21,47,12,24,26,30,104
1459,DET,CLE,L,A,37,99,33,80,4,19,18,19,96
1460,CLE,DET,W,A,46,77,27,47,19,30,17,23,128
1461,PHI,GSW,L,A,39,89,31,62,8,27,18,27,104
1462,GSW,PHI,W,A,32,88,18,56,14,32,28,35,106
1463,POR,NOP,L,A,23,76,12,44,11,32,20,26,77
1464,NOP,POR,W,A,38,80,32,59,6,21,18,30,100
1465,NYK,IND,W,A,35,83,26,55,9,28,8,13,87
1466,IND,NYK,L,A,32,87,24,58,8,29,9,15,81
1467,CHO,CHI,L,A,43,93,36,64,7,29,16,19,109
1468,CHI,CHO,W,A,41,92,27,52,14,40,19,22,115
1469,LAL,DEN,L,A,42,97,36,77,6,20,11,19,101
1470,DEN,LAL,W,A,45,84,28,46,17,38,22,25,129
1471,MIL,MEM,L,A,31,67,17,41,14,26,17,20,93
1472,MEM,MIL,W,A,41,79,27,52,14,27,17,23,113
1473,WAS,MIN,L,A,36,84,29,58,7,26,25,31,104
1474,MIN,WAS,W,A,45,86,35,65,10,21,19,22,119
1475,SAC,ORL,W,A,44,82,28,52,16,30,16,21,120
1476,ORL,SAC,L,A,45,98,32,64,13,34,12,12,115
1477,SAS,ATL,W,A,39,81,23,47,16,34,13,17,107
1478,ATL,SAS,L,A,37,81,31,59,6,22,19,30,99
1479,TOR,DAL,W,A,37,78,28,53,9,25,17,18,100
1480,DAL,TOR,L,A,31,85,24,60,7,25,9,13,78
1481,UTA,LAC,W,A,41,78,27,57,14,21,18,22,114
1482,LAC,UTA,L,A,39,78,27,48,12,30,18,23,108
1483,CHI,BOS,L,A,33,87,26,62,7,25,7,9,80
1484,BOS,CHI,W,A,40,86,24,49,16,37,4,4,100
1485,NYK,BRK,L,A,39,94,31,71,8,23,26,32,112
1486,BRK,NYK,W,A,40,87,21,49,19,38,21,29,120
1487,HOU,CLE,W,A,41,96,25,51,16,45,19,28,117
1488,CLE,HOU,L,A,42,80,25,37,17,43,11,13,112
1489,MIA,IND,L,A,39,94,30,62,9,32,11,16,98
1490,IND,MIA,W,A,35,82,30,67,5,15,27,32,102
1491,PHI,LAL,W,A,41,79,31,55,10,24,26,32,118
1492,LAL,PHI,L,A,44,88,40,68,4,20,24,28,116
1493,POR,PHO,W,A,43,86,36,64,7,22,17,25,110
1494,PHO,POR,L,A,41,93,36,79,5,14,14,20,101
1495,NOP,CHO,W,A,50,99,36,65,14,34,11,16,125
1496,CHO,NOP,L,A,46,102,33,56,13,46,17,20,122
1497,PHO,DAL,W,A,38,83,32,62,6,21,18,20,100
1498,DAL,PHO,L,A,28,74,19,48,9,26,33,36,98
1499,NYK,DET,L,A,36,82,23,52,13,30,7,11,92
1500,DET,NYK,W,A,46,96,37,69,9,27,11,19,112
1501,PHI,LAC,L,A,40,84,30,54,10,30,10,14,100
1502,LAC,PHI,W,A,40,81,32,56,8,25,24,29,112
1503,MEM,ATL,L,A,34,90,29,61,5,29,17,23,90
1504,ATL,MEM,W,A,36,72,21,42,15,30,20,26,107
1505,TOR,MIA,L,A,33,88,31,73,2,15,21,25,89
1506,MIA,TOR,W,A,35,72,24,44,11,28,23,33,104
1507,MIN,MIL,L,A,37,81,32,68,5,13,16,21,95
1508,MIL,MIN,W,A,37,80,29,60,8,20,20,23,102
1509,UTA,OKC,L,A,36,75,27,55,9,20,23,28,104
1510,OKC,UTA,W,A,43,86,35,63,8,23,18,24,112
1511,ORL,CLE,L,A,38,96,34,75,4,21,24,28,104
1512,CLE,ORL,W,A,43,86,28,47,15,39,15,25,116
1513,WAS,POR,W,A,47,90,35,65,12,25,19,28,125
1514,POR,WAS,L,A,48,94,32,62,16,32,12,16,124
1515,SAC,DEN,L,A,36,82,28,59,8,23,12,20,92
1516,DEN,SAC,W,A,40,85,31,51,9,34,16,18,105
1517,SAS,GSW,W,A,40,77,28,50,12,27,15,18,107
1518,GSW,SAS,L,A,33,92,28,75,5,17,14,23,85
1519,TOR,ATL,L,A,37,92,33,67,4,25,21,27,99
1520,ATL,TOR,W,A,39,75,31,53,8,22,19,29,105
1521,HOU,CHI,W,A,37,89,22,42,15,47,26,32,115
1522,CHI,HOU,L,A,38,98,29,59,9,39,9,12,94
1523,ORL,CHO,L,A,31,76,26,49,5,27,14,22,81
1524,CHO,ORL,W,A,47,79,37,58,10,21,17,20,121
1525,DAL,BRK,W,A,33,78,19,45,14,33,25,28,105
1526,BRK,DAL,L,A,34,78,25,47,9,31,19,23,96
1527,DEN,BOS,W,A,45,85,33,54,12,31,17,22,119
1528,BOS,DEN,L,A,34,81,22,48,12,33,19,23,99
1529,MIL,IND,W,A,33,64,26,47,7,17,26,30,99
1530,IND,MIL,L,A,33,75,31,57,2,18,17,22,85
1531,MIN,GSW,W,A,39,88,35,74,4,14,21,27,103
1532,GSW,MIN,L,A,41,88,34,64,7,24,13,17,102
1533,WAS,SAC,W,A,52,104,43,78,9,26,17,19,130
1534,SAC,WAS,L,A,44,92,32,69,12,23,22,28,122
1535,DET,CLE,W,A,41,88,32,62,9,26,15,19,106
1536,CLE,DET,L,A,39,84,28,45,11,39,12,19,101
1537,MEM,LAC,L,A,37,83,30,63,7,20,17,22,98
1538,LAC,MEM,W,A,40,78,29,48,11,30,23,28,114
1539,SAS,OKC,L,A,35,84,29,65,6,19,16,20,92
1540,OKC,SAS,W,A,41,89,35,69,6,20,14,21,102
1541,PHO,LAL,L,A,42,91,36,72,6,19,20,25,110
1542,LAL,PHO,W,A,47,98,35,71,12,27,16,24,122
1543,POR,PHI,W,A,40,88,34,67,6,21,28,33,114
1544,PHI,POR,L,A,41,94,30,65,11,29,15,20,108
1545,BRK,ATL,L,A,37,80,26,47,11,33,20,25,105
1546,ATL,BRK,W,A,41,95,37,75,4,20,24,32,110
1547,WAS,DEN,W,A,50,88,39,62,11,26,12,19,123
1548,DEN,WAS,L,A,46,87,33,59,13,28,8,17,113
1549,GSW,BOS,L,A,37,84,31,54,6,30,6,9,86
1550,BOS,GSW,W,A,37,84,27,55,10,29,15,19,99
1551,UTA,HOU,W,A,41,76,29,45,12,31,21,24,115
1552,HOU,UTA,L,A,35,79,27,47,8,32,30,40,108
1553,IND,DET,W,A,44,88,33,65,11,23,16,19,115
1554,DET,IND,L,A,39,89,32,63,7,26,13,22,98
1555,MIA,CHO,W,A,37,85,20,44,17,41,17,24,108
1556,CHO,MIA,L,A,37,80,30,59,7,21,20,21,101
1557,NYK,MIL,L,A,39,84,32,63,7,21,8,12,93
1558,MIL,NYK,W,A,37,86,29,60,8,26,22,28,104
1559,MIN,LAC,W,A,42,86,37,66,5,20,18,20,107
1560,LAC,MIN,L,A,35,83,26,59,9,24,12,18,91
1561,TOR,NOP,W,A,36,76,28,55,8,21,14,23,94
1562,NOP,TOR,L,A,34,80,25,51,9,29,10,13,87
1563,ORL,CHI,W,A,37,89,30,64,7,25,17,21,98
1564,CHI,ORL,L,A,36,81,24,53,12,28,7,11,91
1565,SAS,SAC,W,A,42,84,28,55,14,29,16,21,114
1566,SAC,SAS,L,A,42,86,35,67,7,19,13,16,104
1567,LAL,DAL,L,A,42,90,31,60,11,30,16,22,111
1568,DAL,LAL,W,A,45,83,28,52,17,31,15,19,122
1569,POR,OKC,W,A,47,85,36,62,11,23,21,27,126
1570,OKC,POR,L,A,44,85,34,60,10,25,23,30,121
1571,WAS,PHO,W,A,41,90,34,72,7,18,42,53,131
1572,PHO,WAS,L,A,44,88,31,61,13,27,26,33,127
1573,GSW,ATL,W,A,41,87,21,43,20,44,17,22,119
1574,ATL,GSW,L,A,38,82,25,54,13,28,22,31,111
1575,IND,CHO,L,A,37,81,25,51,12,30,2,3,88
1576,CHO,IND,W,A,35,86,24,55,11,31,19,21,100
1577,MIA,CLE,W,A,39,91,23,56,16,35,12,14,106
1578,CLE,MIA,L,A,35,78,26,51,9,27,19,29,98
1579,SAC,DEN,L,A,36,83,30,67,6,16,18,21,96
1580,DEN,SAC,W,A,37,74,24,44,13,30,21,28,108
1581,DET,CHI,W,A,45,92,39,71,6,21,13,20,109
1582,CHI,DET,L,A,34,83,26,55,8,28,19,21,95
1583,LAC,BOS,W,A,39,73,30,53,9,20,29,47,116
1584,BOS,LAC,L,A,34,83,24,48,10,35,24,29,102
1585,MEM,BRK,L,A,34,77,24,52,10,25,31,39,109
1586,BRK,MEM,W,A,39,73,25,43,14,30,30,38,122
1587,ORL,NYK,L,A,40,85,31,53,9,32,16,24,105
1588,NYK,ORL,W,A,40,86,34,72,6,14,27,28,113
1589,PHI,MIL,L,A,39,89,31,59,8,30,12,19,98
1590,MIL,PHI,W,A,41,83,27,50,14,33,16,20,112
1591,SAS,HOU,W,A,40,88,29,60,11,28,21,23,112
1592,HOU,SAS,L,A,41,88,27,49,14,39,14,17,110
1593,UTA,NOP,W,A,33,81,23,54,10,27,12,15,88
1594,NOP,UTA,L,A,30,84,20,51,10,33,13,18,83
1595,IND,ATL,W,A,35,78,20,45,15,33,12,21,97
1596,ATL,IND,L,A,34,77,25,50,9,27,19,31,96
1597,OKC,DAL,L,A,33,82,31,60,2,22,21,30,89
1598,DAL,OKC,W,A,42,86,35,61,7,25,13,16,104
1599,NOP,LAL,W,A,36,89,27,65,9,24,24,35,105
1600,LAL,NOP,L,A,38,83,28,55,10,28,11,15,97
1601,NYK,GSW,L,A,39,83,32,61,7,22,20,25,105
1602,GSW,NYK,W,A,40,88,27,53,13,35,19,23,112
1603,PHO,BOS,W,A,42,94,38,74,4,20,21,26,109
1604,BOS,PHO,L,A,32,85,19,48,13,37,29,40,106
1605,UTA,SAC,W,A,41,90,31,57,10,33,18,27,110
1606,SAC,UTA,L,A,43,83,35,66,8,17,15,20,109
1607,WAS,ORL,W,A,39,81,25,55,14,26,23,25,115
1608,ORL,WAS,L,A,44,89,30,54,14,35,12,19,114
1609,LAC,CHI,W,A,41,85,35,60,6,25,13,16,101
1610,CHI,LAC,L,A,35,83,29,66,6,17,15,20,91
1611,DEN,CHO,L,A,36,80,27,50,9,30,21,25,102
1612,CHO,DEN,W,A,41,90,25,63,16,27,14,17,112
1613,MEM,HOU,L,A,43,97,35,69,8,28,14,21,108
1614,HOU,MEM,W,A,39,78,21,36,18,42,27,36,123
1615,MIA,CLE,W,A,46,88,28,54,18,34,10,12,120
1616,CLE,MIA,L,A,35,73,24,46,11,27,11,18,92
1617,TOR,MIL,L,A,35,75,28,54,7,21,17,20,94
1618,MIL,TOR,W,A,38,87,32,60,6,27,19,23,101
1619,PHI,DET,L,A,43,88,29,54,14,34,6,7,106
1620,DET,PHI,W,A,54,95,44,72,10,23,18,21,136
1621,POR,BRK,W,A,49,86,33,61,16,25,16,22,130
1622,BRK,POR,L,A,45,86,31,56,14,30,12,17,116
1623,SAS,MIN,W,A,38,94,32,70,6,24,15,24,97
1624,MIN,SAS,L,A,35,89,31,73,4,16,16,22,90
1625,CLE,ATL,W,A,47,86,22,40,25,46,16,20,135
1626,ATL,CLE,L,A,49,91,39,65,10,26,22,30,130
1627,MEM,DAL,L,A,38,82,29,54,9,28,15,22,100
1628,DAL,MEM,W,A,39,82,34,55,5,27,21,27,104
1629,LAL,BOS,L,A,37,87,31,63,6,24,15,20,95
1630,BOS,LAL,W,A,43,84,33,51,10,33,19,25,115
1631,MIL,LAC,W,A,44,80,34,55,10,25,14,15,112
1632,LAC,MIL,L,A,36,64,28,45,8,19,21,36,101
1633,SAS,NOP,W,A,40,95,34,68,6,27,15,25,101
1634,NOP,SAS,L,A,35,91,27,66,8,25,20,24,98
1635,ORL,MIA,W,A,45,90,40,73,5,17,15,19,110
1636,MIA,ORL,L,A,35,91,27,63,8,28,21,25,99
1637,PHI,NYK,W,A,36,83,27,55,9,28,24,31,105
1638,NYK,PHI,L,A,33,84,26,63,7,21,29,33,102
1639,PHO,OKC,W,A,44,89,39,68,5,21,25,31,118
1640,OKC,PHO,L,A,37,87,28,52,9,35,28,35,111
1641,UTA,BRK,W,A,38,74,26,48,12,26,24,34,112
1642,BRK,UTA,L,A,36,89,29,59,7,30,18,24,97
1643,WAS,TOR,L,A,34,92,24,62,10,30,28,32,106
1644,TOR,WAS,W,A,41,81,30,56,11,25,21,27,114
1645,GSW,CHI,L,A,34,88,28,58,6,30,13,14,87
1646,CHI,GSW,W,A,36,82,31,63,5,19,17,21,94
1647,PHO,CHO,W,A,46,77,39,58,7,19,21,25,120
1648,CHO,PHO,L,A,35,89,25,55,10,34,23,28,103
1649,POR,OKC,W,A,39,79,29,54,10,25,26,35,114
1650,OKC,POR,L,A,34,86,23,57,11,29,30,32,109
1651,DAL,ATL,L,A,35,77,21,44,14,33,11,13,95
1652,ATL,DAL,W,A,36,64,26,43,10,21,18,24,100
1653,CLE,BOS,L,A,37,91,27,58,10,33,15,22,99
1654,BOS,CLE,W,A,36,78,23,47,13,31,18,23,103
1655,LAC,HOU,L,A,42,94,30,60,12,34,7,13,103
1656,HOU,LAC,W,A,37,87,17,35,20,52,28,33,122
1657,PHI,MIA,L,A,37,85,31,68,6,17,18,22,98
1658,MIA,PHI,W,A,49,90,36,60,13,30,14,21,125
1659,MIL,DEN,L,A,38,83,29,65,9,18,13,15,98
1660,DEN,MIL,W,A,41,84,31,51,10,33,18,20,110
1661,NOP,DET,W,A,39,78,30,53,9,25,22,23,109
1662,DET,NOP,L,A,40,103,37,80,3,23,3,17,86
1663,ORL,NYK,L,A,34,83,29,58,5,25,17,22,90
1664,NYK,ORL,W,A,34,81,26,52,8,29,25,31,101
1665,SAC,BRK,L,A,35,81,24,59,11,22,19,22,100
1666,BRK,SAC,W,A,34,74,23,46,11,28,30,36,109
1667,SAS,IND,W,A,35,74,26,45,9,29,21,24,100
1668,IND,SAS,L,A,37,81,30,58,7,23,18,25,99
1669,WAS,TOR,W,A,40,84,31,59,9,25,16,19,105
1670,TOR,WAS,L,A,33,90,26,70,7,20,23,26,96
1671,UTA,MIN,L,A,35,90,31,71,4,19,6,11,80
1672,MIN,UTA,W,A,39,78,31,62,8,16,21,26,107
1673,DEN,CHI,W,A,45,80,32,50,13,30,22,24,125
1674,CHI,DEN,L,A,44,96,34,70,10,26,9,10,107
1675,POR,DET,L,A,44,84,34,59,10,25,15,22,113
1676,DET,POR,W,A,45,104,38,79,7,25,23,31,120
1677,LAL,CHO,L,A,41,84,29,52,12,32,10,13,104
1678,CHO,LAL,W,A,38,85,22,46,16,39,17,24,109
1679,PHO,MEM,L,A,43,83,36,62,7,21,19,24,112
1680,MEM,PHO,W,A,48,86,36,61,12,25,22,29,130
1681,UTA,OKC,L,A,43,93,34,71,9,22,11,13,106
1682,OKC,UTA,W,A,39,76,24,54,15,22,16,23,109
1683,WAS,GSW,W,A,41,91,29,63,12,28,18,20,112
1684,GSW,WAS,L,A,39,84,31,55,8,29,22,27,108
1685,BOS,ATL,L,A,34,87,24,53,10,34,20,25,98
1686,ATL,BOS,W,A,46,95,40,70,6,25,16,20,114
1687,MIL,CLE,L,A,37,83,26,53,11,30,10,16,95
1688,CLE,MIL,W,A,35,70,25,42,10,28,22,26,102
1689,MIA,DAL,L,A,37,83,28,57,9,26,6,13,89
1690,DAL,MIA,W,A,33,76,24,58,9,18,21,23,96
1691,IND,HOU,W,A,41,91,28,61,13,30,22,25,117
1692,HOU,IND,L,A,32,88,22,43,10,45,34,42,108
1693,TOR,NYK,W,A,33,78,26,52,7,26,19,23,92
1694,NYK,TOR,L,A,33,73,24,49,9,24,16,19,91
1695,PHI,GSW,L,A,37,82,27,48,10,34,24,27,108
1696,GSW,PHI,W,A,40,89,34,60,6,29,33,39,119
1697,SAC,MIN,L,A,36,82,30,65,6,17,10,15,88
1698,MIN,SAC,W,A,40,95,32,72,8,23,14,20,102
1699,MEM,DEN,W,A,36,80,25,47,11,33,22,25,105
1700,DEN,MEM,L,A,37,84,26,50,11,34,13,17,98
1701,DET,BOS,L,A,35,81,23,48,12,33,16,35,98
1702,BOS,DET,W,A,34,85,22,50,12,35,24,30,104
1703,LAC,CHO,W,A,45,97,35,65,10,32,24,34,124
1704,CHO,LAC,L,A,38,80,20,40,18,40,27,30,121
1705,SAS,LAL,W,A,49,94,39,73,10,21,11,13,119
1706,LAL,SAS,L,A,40,87,33,65,7,22,11,18,98
1707,PHO,MIL,L,A,40,83,35,69,5,14,11,16,96
1708,MIL,PHO,W,A,39,76,33,56,6,20,16,18,100
1709,OKC,NOP,W,A,42,88,36,67,6,21,28,37,118
1710,NOP,OKC,L,A,36,80,28,59,8,21,30,37,110
1711,TOR,POR,W,A,42,78,35,58,7,20,21,27,112
1712,POR,TOR,L,A,35,79,26,58,9,21,27,35,106
1713,WAS,UTA,L,A,37,87,29,65,8,22,10,13,92
1714,UTA,WAS,W,A,34,72,23,48,11,24,23,32,102
1715,CLE,CHI,L,A,37,80,23,43,14,37,11,15,99
1716,CHI,CLE,W,A,46,93,31,63,15,30,10,16,117
1717,NOP,DAL,L,A,31,78,26,54,5,24,16,25,83
1718,DAL,NOP,W,A,36,78,24,52,12,26,12,16,96
1719,GSW,BRK,W,A,42,100,31,69,11,31,17,22,112
1720,BRK,GSW,L,A,38,94,30,66,8,28,11,17,95
1721,MIN,HOU,L,A,49,94,40,68,9,26,23,28,130
1722,HOU,MIN,W,A,44,94,22,36,22,58,32,42,142
1723,MIA,IND,W,A,38,78,25,47,13,31,24,31,113
1724,IND,MIA,L,A,34,85,30,73,4,12,23,26,95
1725,PHI,NYK,L,A,40,95,33,64,7,31,22,27,109
1726,NYK,PHI,W,A,43,91,37,70,6,21,18,23,110
1727,ORL,ATL,W,A,37,81,29,54,8,27,23,24,105
1728,ATL,ORL,L,A,32,85,24,60,8,25,14,26,86
1729,SAC,CHO,L,A,31,79,20,51,11,28,12,15,85
1730,CHO,SAC,W,A,34,85,20,47,14,38,17,18,99
1731,MIA,ATL,W,A,40,99,23,62,17,37,11,13,108
1732,ATL,MIA,L,A,30,79,24,59,6,20,24,36,90
1733,PHO,CHI,L,A,49,93,41,69,8,24,15,25,121
1734,CHI,PHO,W,A,46,98,34,72,12,26,24,31,128
1735,DEN,BRK,W,A,49,97,35,66,14,31,17,24,129
1736,BRK,DEN,L,A,41,83,31,53,10,30,17,31,109
1737,MEM,IND,L,A,35,84,26,57,9,27,13,23,92
1738,IND,MEM,W,A,40,78,29,52,11,26,11,11,102
1739,SAS,LAC,W,A,35,82,26,56,9,26,26,30,105
1740,LAC,SAS,L,A,35,79,28,56,7,23,20,24,97
1741,UTA,MIL,W,A,37,74,29,51,8,23,27,30,109
1742,MIL,UTA,L,A,32,74,25,56,7,18,24,29,95
1743,MIN,DAL,W,A,41,78,36,65,5,13,10,14,97
1744,DAL,MIN,L,A,35,83,27,50,8,33,6,9,84
1745,OKC,LAL,W,A,44,97,34,73,10,24,12,17,110
1746,LAL,OKC,L,A,40,101,33,66,7,35,6,14,93
1747,WAS,PHI,L,A,38,90,33,66,5,24,31,40,112
1748,PHI,WAS,W,A,43,87,33,58,10,29,24,30,120
1749,TOR,BOS,W,A,40,81,35,66,5,15,22,29,107
1750,BOS,TOR,L,A,33,78,21,40,12,38,19,22,97
1751,NYK,CLE,L,A,42,101,34,75,8,26,12,17,104
1752,CLE,NYK,W,A,46,87,31,49,15,38,12,15,119
1753,DET,CHO,W,A,44,107,29,70,15,37,11,12,114
1754,CHO,DET,L,A,38,92,31,62,7,30,25,26,108
1755,LAC,GSW,L,A,38,93,27,65,11,28,26,37,113
1756,GSW,LAC,W,A,43,81,30,56,13,25,24,26,123
1757,NOP,HOU,L,A,36,86,30,55,6,31,21,26,99
1758,HOU,NOP,W,A,45,91,25,40,20,51,19,24,129
1759,POR,ORL,W,A,41,81,32,63,9,18,21,27,112
1760,ORL,POR,L,A,34,86,27,64,7,22,28,39,103
1761,SAC,DEN,W,A,46,88,39,74,7,14,17,19,116
1762,DEN,SAC,L,A,39,88,27,53,12,35,10,14,100
1763,CHI,BOS,W,A,38,90,32,65,6,25,22,22,104
1764,BOS,CHI,L,A,36,77,22,40,14,37,17,20,103
1765,WAS,IND,W,A,43,83,28,54,15,29,10,15,111
1766,IND,WAS,L,A,40,80,36,62,4,18,14,18,98
1767,PHI,BOS,L,A,44,93,36,62,8,31,12,18,108
1768,BOS,PHI,W,A,38,80,25,52,13,28,27,36,116
1769,MIL,BRK,W,A,50,88,43,73,7,15,22,32,129
1770,BRK,MIL,L,A,46,88,32,52,14,36,19,23,125
1771,IND,CLE,L,A,40,86,28,62,12,24,12,14,104
1772,CLE,IND,W,A,39,82,21,43,18,39,17,19,113
1773,MIN,DEN,W,A,41,86,35,68,6,18,24,28,112
1774,DEN,MIN,L,A,38,94,27,60,11,34,12,18,99
1775,DET,DAL,W,A,36,82,30,63,6,19,20,22,98
1776,DAL,DET,L,A,35,92,25,55,10,37,11,11,91
1777,SAC,GSW,L,A,33,89,26,65,7,24,13,17,86
1778,GSW,SAC,W,A,41,84,28,48,13,36,14,21,109
1779,MIA,HOU,W,A,44,84,31,49,13,35,16,24,117
1780,HOU,MIA,L,A,36,87,23,47,13,40,24,31,109
1781,LAC,ATL,W,A,37,79,23,42,14,37,11,12,99
1782,ATL,LAC,L,A,32,79,25,53,7,26,13,19,84
1783,NOP,MEM,W,A,37,75,29,57,8,18,13,22,95
1784,MEM,NOP,L,A,33,89,27,56,6,33,19,25,91
1785,OKC,NYK,W,A,41,88,29,65,12,23,22,31,116
1786,NYK,OKC,L,A,41,86,30,65,11,21,12,14,105
1787,SAS,ORL,W,A,42,89,34,58,8,31,15,19,107
1788,ORL,SAS,L,A,30,76,26,58,4,18,15,19,79
1789,PHO,LAL,W,A,49,88,39,64,10,24,29,34,137
1790,LAL,PHO,L,A,35,93,26,67,9,26,22,28,101
1791,TOR,CHO,W,A,32,84,20,52,12,32,14,19,90
1792,CHO,TOR,L,A,32,76,19,38,13,38,8,9,85
1793,UTA,POR,W,A,42,81,31,59,11,22,16,23,111
1794,POR,UTA,L,A,32,79,23,57,9,22,15,20,88
1795,TOR,CHI,L,A,35,77,30,57,5,20,19,24,94
1796,CHI,TOR,W,A,35,73,28,56,7,17,28,35,105
1797,SAC,LAL,W,A,36,73,29,49,7,24,18,25,97
1798,LAL,SAC,L,A,38,83,26,54,12,29,8,15,96
1799,MIN,CLE,L,A,42,86,33,63,9,23,15,19,108
1800,CLE,MIN,W,A,44,86,31,47,13,39,15,22,116
1801,MEM,BRK,W,A,39,77,30,55,9,22,25,27,112
1802,BRK,MEM,L,A,38,82,26,45,12,37,15,18,103
1803,PHI,CHO,W,A,41,86,29,53,12,33,11,17,105
1804,CHO,PHI,L,A,34,78,23,47,11,31,20,26,99
1805,DAL,BOS,L,A,35,77,26,50,9,27,19,25,98
1806,BOS,DAL,W,A,40,81,24,47,16,34,15,18,111
1807,GSW,DEN,L,A,45,92,37,60,8,32,12,13,110
1808,DEN,GSW,W,A,48,88,24,47,24,41,12,16,132
1809,SAS,IND,W,A,40,87,33,72,7,15,23,27,110
1810,IND,SAS,L,A,38,78,29,58,9,20,21,30,106
1811,ORL,MIA,W,A,44,90,36,76,8,14,20,29,116
1812,MIA,ORL,L,A,39,83,33,61,6,22,23,27,107
1813,MIL,DET,W,A,40,79,34,58,6,21,16,16,102
1814,DET,MIL,L,A,34,78,27,57,7,21,14,19,89
1815,PHO,NOP,L,A,40,93,32,70,8,23,20,24,108
1816,NOP,PHO,W,A,37,78,29,50,8,28,28,35,110
1817,POR,ATL,L,A,37,103,21,61,16,42,14,25,104
1818,ATL,POR,W,A,32,83,24,55,8,28,37,48,109
1819,UTA,LAC,L,A,28,87,24,64,4,23,12,18,72
1820,LAC,UTA,W,A,36,81,27,56,9,25,7,11,88
1821,WAS,OKC,W,A,42,73,29,53,13,20,23,28,120
1822,OKC,WAS,L,A,34,96,27,62,7,34,23,30,98
1823,MIN,CHI,W,A,44,81,38,57,6,24,23,26,117
1824,CHI,MIN,L,A,35,84,25,59,10,25,9,13,89
1825,SAS,NYK,L,A,33,91,27,62,6,29,18,22,90
1826,NYK,SAS,W,A,34,68,25,54,9,14,17,21,94
1827,SAC,NOP,W,A,35,78,24,47,11,31,24,27,105
1828,NOP,SAC,L,A,34,82,21,51,13,31,18,21,99
1829,TOR,DET,L,A,38,75,30,59,8,16,17,25,101
1830,DET,TOR,W,A,36,84,28,53,8,31,22,29,102
1831,LAC,CHO,W,A,40,85,26,51,14,34,13,20,107
1832,CHO,LAC,L,A,37,85,24,48,13,37,15,20,102
1833,DEN,CLE,L,A,39,97,27,60,12,37,19,22,109
1834,CLE,DEN,W,A,46,84,31,54,15,30,18,22,125
1835,ORL,DAL,L,A,32,82,29,59,3,23,13,18,80
1836,DAL,ORL,W,A,45,91,28,56,17,35,5,6,112
1837,PHO,HOU,L,A,37,94,29,72,8,22,20,26,102
1838,HOU,PHO,W,A,42,85,24,49,18,36,31,39,133
1839,MIL,IND,W,A,35,73,18,42,17,31,29,37,116
1840,IND,MIL,L,A,35,73,25,51,10,22,20,24,100
1841,OKC,GSW,L,A,40,83,34,59,6,24,28,36,114
1842,GSW,OKC,W,A,46,87,33,56,13,31,25,35,130
1843,PHI,MIA,W,A,39,86,30,61,9,25,30,38,117
1844,MIA,PHI,L,A,39,85,32,61,7,24,24,28,109
1845,UTA,BOS,L,A,35,86,27,55,8,31,26,30,104
1846,BOS,UTA,W,A,42,71,29,41,13,30,15,23,112
1847,MIA,BRK,W,A,41,92,34,69,7,23,19,21,108
1848,BRK,MIA,L,A,35,81,27,61,8,20,21,28,99
1849,SAS,DET,W,A,41,82,32,63,9,19,12,15,103
1850,DET,SAS,L,A,39,92,34,75,5,17,9,13,92
1851,MEM,GSW,L,A,34,87,25,61,9,26,30,37,107
1852,GSW,MEM,W,A,39,77,24,44,15,33,29,38,122
1853,MIL,LAL,L,A,40,76,32,48,8,28,26,31,114
1854,LAL,MIL,W,A,39,75,24,44,15,31,29,35,122
1855,NOP,MIN,W,A,45,75,33,50,12,25,20,27,122
1856,MIN,NOP,L,A,38,82,32,55,6,27,24,32,106
1857,NYK,DEN,L,A,52,93,36,55,16,38,3,5,123
1858,DEN,NYK,W,A,54,95,38,63,16,32,7,10,131
1859,PHO,CHI,W,A,48,95,40,76,8,19,11,13,115
1860,CHI,PHO,L,A,37,86,32,67,5,19,18,22,97
1861,SAC,ATL,W,A,38,80,20,44,18,36,14,21,108
1862,ATL,SAC,L,A,36,71,25,41,11,30,24,31,107
1863,WAS,IND,W,A,41,88,31,59,10,29,20,30,112
1864,IND,WAS,L,A,45,92,41,71,4,21,13,15,107
1865,HOU,CHO,W,A,39,87,26,47,13,40,16,20,107
1866,CHO,HOU,L,A,37,85,29,59,8,26,13,14,95
1867,UTA,DAL,L,A,39,85,26,56,13,29,14,17,105
1868,DAL,UTA,W,A,44,87,39,67,5,20,19,25,112
1869,OKC,CLE,W,A,50,106,42,79,8,27,10,13,118
1870,CLE,OKC,L,A,38,79,28,58,10,21,23,30,109
1871,PHI,ORL,W,A,40,95,29,67,11,28,21,27,112
1872,ORL,PHI,L,A,41,84,31,63,10,21,19,24,111
1873,POR,BOS,L,A,39,77,30,51,9,26,24,31,111
1874,BOS,POR,W,A,44,91,34,61,10,30,22,27,120
1875,DEN,ATL,L,A,40,100,27,56,13,44,13,21,106
1876,ATL,DEN,W,A,47,93,39,66,8,27,15,18,117
1877,WAS,BRK,W,A,40,97,31,72,9,25,25,33,114
1878,BRK,WAS,L,A,38,91,29,58,9,33,25,36,110
1879,LAL,DET,L,A,37,86,31,63,6,23,22,26,102
1880,DET,LAL,W,A,51,97,47,81,4,16,15,24,121
1881,GSW,CHI,W,A,48,85,33,57,15,28,12,13,123
1882,CHI,GSW,L,A,37,92,33,68,4,24,14,19,92
1883,IND,CLE,L,A,41,82,28,57,13,25,22,26,117
1884,CLE,IND,W,A,46,84,30,48,16,36,24,26,132
1885,PHO,MEM,L,A,29,87,24,64,5,23,28,34,91
1886,MEM,PHO,W,A,35,72,21,48,14,24,26,34,110
1887,MIL,MIA,L,A,33,71,27,56,6,15,16,28,88
1888,MIA,MIL,W,A,41,86,30,53,11,33,13,18,106
1889,TOR,MIN,L,A,42,79,31,51,11,28,14,20,109
1890,MIN,TOR,W,A,39,80,32,61,7,19,27,30,112
1891,UTA,NOP,W,A,48,88,34,56,14,32,17,21,127
1892,NOP,UTA,L,A,35,77,30,53,5,24,19,25,94
1893,NYK,LAC,L,A,46,92,38,65,8,27,15,18,115
1894,LAC,NYK,W,A,45,92,35,67,10,25,19,28,119
1895,SAS,PHI,W,A,39,74,28,52,11,22,22,25,111
1896,PHI,SAS,L,A,34,84,21,50,13,34,22,29,103
1897,SAC,BOS,W,A,42,84,32,59,10,25,14,15,108
1898,BOS,SAC,L,A,29,73,19,41,10,32,24,27,92
1899,CHO,BRK,W,A,40,102,33,76,7,26,24,29,111
1900,BRK,CHO,L,A,39,86,27,50,12,36,17,21,107
1901,POR,DAL,W,A,42,86,31,58,11,28,19,24,114
1902,DAL,POR,L,A,37,75,25,47,12,28,27,32,113
1903,ORL,HOU,L,A,42,88,36,63,6,25,14,20,104
1904,HOU,ORL,W,A,44,89,28,51,16,38,24,36,128
1905,UTA,ATL,W,A,49,80,39,54,10,26,12,18,120
1906,ATL,UTA,L,A,33,74,27,57,6,17,23,32,95
1907,DEN,DAL,W,A,42,84,31,56,11,28,15,16,110
1908,DAL,DEN,L,A,34,79,26,53,8,26,11,17,87
1909,PHI,DET,L,A,36,85,31,57,5,28,19,28,96
1910,DET,PHI,W,A,46,99,41,77,5,22,16,17,113
1911,OKC,IND,L,A,34,88,27,60,7,28,15,21,90
1912,IND,OKC,W,A,33,87,25,61,8,26,19,29,93
1913,SAS,MEM,L,A,30,82,26,63,4,19,10,18,74
1914,MEM,SAS,W,A,32,81,28,62,4,19,21,25,89
1915,MIN,MIA,L,A,43,80,38,69,5,11,22,28,113
1916,MIA,MIN,W,A,45,86,30,58,15,28,10,14,115
1917,PHO,NOP,L,A,40,93,35,66,5,27,21,25,106
1918,NOP,PHO,W,A,42,92,33,66,9,26,18,22,111
1919,NYK,LAL,L,A,37,82,30,61,7,21,26,33,107
1920,LAL,NYK,W,A,44,102,36,74,8,28,25,31,121
1921,SAC,CHI,L,A,41,79,30,51,11,28,14,16,107
1922,CHI,SAC,W,A,43,81,37,62,6,19,20,31,112
1923,TOR,LAC,W,A,41,84,31,60,10,24,26,29,118
1924,LAC,TOR,L,A,42,90,29,55,13,35,12,18,109
1925,WAS,CLE,L,A,50,99,38,70,12,29,23,26,135
1926,CLE,WAS,W,A,49,92,30,54,19,38,23,28,140
1927,LAC,BOS,L,A,35,84,25,55,10,29,22,28,102
1928,BOS,LAC,W,A,37,88,21,36,16,52,17,20,107
1929,TOR,BRK,W,A,40,87,35,68,5,19,18,20,103
1930,BRK,TOR,L,A,32,76,19,42,13,34,18,21,95
1931,POR,OKC,L,A,35,87,25,59,10,28,19,21,99
1932,OKC,POR,W,A,40,98,36,80,4,18,21,28,105
1933,ORL,ATL,L,A,27,78,20,51,7,27,25,28,86
1934,ATL,ORL,W,A,41,78,31,50,10,28,21,27,113
1935,IND,DET,W,A,44,91,37,67,7,24,10,15,105
1936,DET,IND,L,A,31,75,25,58,6,17,16,20,84
1937,PHI,MIA,L,A,35,84,29,61,6,23,26,31,102
1938,MIA,PHI,W,A,48,82,36,60,12,22,17,23,125
1939,MIN,MEM,L,A,35,84,25,58,10,26,19,24,99
1940,MEM,MIN,W,A,32,77,22,49,10,28,33,39,107
1941,NYK,CLE,L,A,39,86,27,55,12,31,14,28,104
1942,CLE,NYK,W,A,41,84,25,44,16,40,13,18,111
1943,PHO,MIL,L,A,38,91,27,63,11,28,25,30,112
1944,MIL,PHO,W,A,52,82,45,65,7,17,26,35,137
1945,SAC,GSW,W,A,43,88,36,65,7,23,16,19,109
1946,GSW,SAC,L,A,36,87,21,43,15,44,19,24,106
1947,SAS,DEN,W,A,45,79,35,58,10,21,21,26,121
1948,DEN,SAS,L,A,41,92,31,66,10,26,5,10,97
1949,UTA,CHO,W,A,38,81,25,48,13,33,16,24,105
1950,CHO,UTA,L,A,35,82,22,49,13,33,15,18,98
1951,WAS,NOP,W,A,38,83,28,52,10,31,19,22,105
1952,NOP,WAS,L,A,37,84,32,67,5,17,12,22,91
1953,LAL,BOS,L,A,37,94,23,56,14,38,19,26,107
1954,BOS,LAL,W,A,39,82,26,47,13,35,22,28,113
1955,IND,BRK,W,A,37,86,29,66,8,20,24,31,106
1956,BRK,IND,L,A,32,86,21,58,11,28,22,23,97
1957,MIL,DEN,L,A,45,83,36,59,9,24,18,23,117
1958,DEN,MIL,W,A,40,89,31,61,9,28,32,44,121
1959,MIN,DET,L,A,44,89,39,72,5,17,15,19,108
1960,DET,MIN,W,A,44,98,33,72,11,26,17,22,116
1961,HOU,CHI,W,A,44,98,28,55,16,43,17,25,121
1962,CHI,HOU,L,A,48,100,40,75,8,25,13,18,117
1963,OKC,MEM,W,A,38,80,25,54,13,26,25,33,114
1964,MEM,OKC,L,A,40,83,37,64,3,19,19,22,102
1965,TOR,ORL,L,A,34,87,24,59,10,28,16,21,94
1966,ORL,TOR,W,A,37,80,32,66,5,14,23,32,102
1967,POR,DAL,L,A,40,88,31,58,9,30,15,20,104
1968,DAL,POR,W,A,36,76,19,45,17,31,19,23,108
1969,SAC,PHO,L,A,38,85,28,58,10,27,17,22,103
1970,PHO,SAC,W,A,32,77,20,48,12,29,29,35,105
1971,HOU,ATL,L,A,35,93,22,42,13,51,25,33,108
1972,ATL,HOU,W,A,44,85,36,55,8,30,17,23,113
1973,LAC,GSW,L,A,40,80,30,55,10,25,30,39,120
1974,GSW,LAC,W,A,52,99,38,65,14,34,15,18,133
1975,SAS,PHI,W,A,38,89,32,68,6,21,20,27,102
1976,PHI,SAS,L,A,30,88,21,63,9,25,17,23,86
1977,WAS,LAL,W,A,44,96,32,63,12,33,16,21,116
1978,LAL,WAS,L,A,40,87,28,48,12,39,16,22,108
1979,TOR,BOS,L,A,41,78,33,47,8,31,14,25,104
1980,BOS,TOR,W,A,36,87,24,51,12,36,25,30,109
1981,NYK,BRK,W,A,35,99,29,72,6,27,19,31,95
1982,BRK,NYK,L,A,37,88,32,63,5,25,11,16,90
1983,MIN,CLE,L,A,41,94,34,73,7,21,8,10,97
1984,CLE,MIN,W,A,48,89,33,52,15,37,14,22,125
1985,PHI,DAL,L,A,35,77,29,55,6,22,19,26,95
1986,DAL,PHI,W,A,40,86,30,60,10,26,23,28,113
1987,MEM,DEN,W,A,45,92,31,62,14,30,15,20,119
1988,DEN,MEM,L,A,32,80,23,55,9,25,26,35,99
1989,NOP,DET,L,A,41,82,36,61,5,21,11,14,98
1990,DET,NOP,W,A,48,88,38,62,10,26,12,17,118
1991,GSW,CHO,W,A,47,96,26,48,21,48,11,14,126
1992,CHO,GSW,L,A,39,88,30,57,9,31,24,26,111
1993,MIA,ATL,W,A,45,93,33,61,12,32,14,19,116
1994,ATL,MIA,L,A,34,86,27,60,7,26,18,21,93
1995,OKC,CHI,L,A,38,100,28,63,10,37,14,17,100
1996,CHI,OKC,W,A,49,81,43,66,6,15,24,30,128
1997,ORL,IND,L,A,31,77,25,53,6,24,20,28,88
1998,IND,ORL,W,A,33,69,24,49,9,20,23,26,98
1999,PHO,LAC,L,A,39,96,32,76,7,20,29,35,114
2000,LAC,PHO,W,A,44,85,39,66,5,19,31,38,124